   16     2    13    24     5    11    16     0    13    14    16    18    10     7     1     7     2     7    19 
   20    25    18     1     9    18     3     7     4    18    10    12    18    18    25    20     7    20    14 
   24    18     1    17     3    23    15     4     7    14    22    13     0    22     9    10    22    22    22 
   19     1    22     4    18     4    15    16     0     1     6    13     6     4     5     1    20    23     4 
    6    10    13    14    11    22    22    25     0     0    12     1     2    21     9    25    12    23    18 
   20    10     8     3    16    14    15     6    10    24    25    22     3     4    12    11     8     6    16 
   18     8    22    24     3     9     3    13     3    10     5    10    13     8     2     1     8    21    22 
   17    19    24    16     6     4     2    22    16    19     0     0    12     7    18     1    24    25    21 
   12    13    13    23     5    23    18     1     9    25     2     9    23    17    24    12     2    21    21 
    7    10     7    13     3     8     0     3     0     9    22    18    11     5    16    24     5    19    12 
   18     5    25    18    17     5     9    23    17    14    10    19     8    22    25    11     1    14    13 
    1     5    20    17     7    20     9    24    24    10     9    15    18    22     1    20    18    13     5 
   19    24    13    22     9    16    25     2    15    18     3     4    18     4     1    21    17    19    15 
   19     0    20    12    14    12    16     7     9     8     0    14    13    25     9     9     7     7    24 
    8    22     8    12     4    16     4     2    13     0    20    11    12    23     2    20     0    24     7 
   17     4     3    10    25    13    11    25    15    17    13     5    12    22     5    18     3    18    22 
    8    15     4     8    15     4    11    13    20    11    20    10    23    14    20    24    18    12    10 
    3     7    17    25     7    20     8     2    22     8    17    19    14    15     6    24     9     3     1 
   17    19     6     9    20     3    15    24    12     2    13     1     5    13    19    17    11    11    12 


   11    16     0     5    10    18    12    14     9     0    24     0     2    20    13    11    17     9    18 
   11     4    25    24     0    20    22    10     0    16    15    16     7     1     2    12     0    16    23 
    3     7    20    18    12     5    21    18    17     3     8    20    25    18     1    20    23     5     9 
    9     9    15    11     2     9    13    22    23    24    15    11    13    20     4    17    16    21     1 
   21    20     4    20    23     4    15     6    12    18     4     2    10    22     2    25     1    14     3 
    4     8     8    16    10    22     0    14    21     3    23    21     0    16    17    13     2    24    16 
    0    10    17    10    23    11     5    11    22    23    20    19    15     5    20     8    15    25    20 
   11     4     0    16    12    18    10    21     3     5    21    10    24    11    11     4    24    19    12 
    6    25    21     5    22     0    20     5     5    16    22    16    16     4    10     2     0     5     9 
    3     3    22    21    25    21     0    23    16    17    22     9     0     5     2     0     3    11     8 
    1     9    17    13     0    13    15     1     6    19    11    21    11    13    11     1    20    17    21 
   23     1    20     7    15    12    23    14    17    16     5    21    15    16    17    20     2    18    18 
   25    16    11     0     7    13     7    13    21    18    23    20    11    15    14    22    11    16     7 
    6     2     5    24    17    21    11    16    20     0     3     9    16    14    12    15     2     8    15 
   14    10    19    16    17     5    10    11    25     2    12    22    25     1    12    16    10     4    20 
   23     7     0     7     2    17    25     7    18    10    11    24    16     6    15     2     9     5     2 
   11    22     9    25    12     8     8    18    19    24    20    19    24    14    25    20    15    11     6 
   22    11    11     8    18    15    16    11    21     0    25     0    19     5    15     8    11    11    10 
   18     8     0    22     8    20    12    19     8    16    12    24     9     8     1    23    23    10    18 


   20     3    12    21     3    16    22    21     4    17    12    15     2    13     2     2    11     4    15 
   21     2    22    18     6     2    20     4     8     6    22    13    25     1    10    24    25     9    14 
   14    17     3    21    24    18     5    14    11    20    18     7    12    18    15     9    23    22    23 
   17     9    13    14    18     0    20    10     6     4    11    21     2    12     1    12    18     8    20 
   23    21    10    17    10     5    12     6    24    10     7    24     9    10     8    25     7    24    21 
    3     8    16     1     6     4    25     2    22     1     5     3    19     8     4    18    15    20     7 
    9    22    13     6     5    13    15    22     3     8    15    15    14     1     3     2     9     5     5 
    5    20     0     8    10     6    18     9     1     9     1     7    16    14    19    19    13     9     2 
    7     7     8    23     4     6     5    10    21    21    24     4     9     0    24     7     0    14     6 
   13    11    13    18    17    14    25     1     2     4     7    10     6    25     8    21     0     5     0 
   20     3    23    18    18     3     8    12    17    23    13     4    18     7     6    23    14     6    20 
    4    22     5     9     0    16     1     7     2     4    15    11     4     9     5    21    25    18     5 
    5    25    16    24     2     5    11     1    19    19    19    14     8    18     1     8     0     2    22 
   21     1    21    15    24    25     8    13    22     1     9     1    14     3     1    18     6     6    18 
    3    24     3    13    20    11    25    25    18     9     5    12     4    19    24     0     2     0    20 
   18    10    10     7    18     0     1    23    24    22     0     5    17    12     6    20    12    11    13 
   25    16     7    19    20    25    16    22    21    18    24    10     2    25    12     7     7    16    22 
   10    22     8    11     2    25     3     2    22    16     4    20     4     8    13    21    10    21    25 
   25    16     0    15    25     8    23     0    21    11    15    11     2    19    24     8    21    22    24 


    6    25    24    25    10    20    20     9    12    10     6     3    11     6    10    20     8    15    17 
   16    24    18     7    22    21     4    16    14    24     9    19     6    21    10    11    22    15    22 
    0    21    22    17    24     8     4    24    13    25    19    14    22    21     8    16    10     2     8 
    7    14    10     6     7     4    19    20    15    22     2    20    23    21     1    18    17    11     0 
   12     7     7     9    21    20    23    22    17     0     7     5     4    25     0     5    18     3    22 
   23    21    17    18     8     5    14    11     0    15    19    11     5    12     9    18     5     1     7 
   19    17     6    14    25     7     0     5     1     5     2    24     3    18    21     3     6    16    24 
    2     2    20    11     4     0    21    14     4    19    24    17    10     9    17    14     3    11     2 
    3     3    17    20     4     9     0    17     9     5    25     2     7    25     4    24    20    23    10 
   10    14     0    19    10    14    24    11    10    12     0    16     7     1     1    20     2     9    23 
    7     5     4    23    18    23     8    13     6    25     0    14     5     9    21    15    23    12    14 
   10    17    24    16     1     2     5    22     6     5    19    20     6    13    12    15     6    18    17 
   11     9    15    13    18    23     8    24     5    20    19     7    25    13    22    22    16     0    10 
    3     7    21     5    18    23    11    10     5     2    21    22    20    23     9    25     0     4    12 
    2     0    16    11    14    15     2     7    21    24    14    14     4     4     3    11     8    12    21 
   21    11     6    18    13    18     6    19    14    19     7    24     6    14    18    10    19    17     8 
    8    17     4    14    22    13     3    14     7     0     4    23     5    17    18     9    15    19    11 
   25    13    11    18    11     1     5    12     0     0     0     9     9    21     6    13    16    16    10 
   17    19     9    18     5     7     7    14    20     0    23    25    11     7    14    10    24    17    14 


   19    11     5     3    11    12    16    14    14    25     6    17    23    22    23    17     0     3    23 
   16     7     8    21    18    19    17     5     4     9    18    25    24    21    22    17    25    11     0 
   13    23    21    17    24     2    21     0     7     0    21     2     8     1    17     9    24    13    20 
   10    16     7     6    11     7    11     5    16     4     0    15    13     4    15     2    23    19    23 
   15     8     8     2    18     4    15    13    17     6    12    22    20     6    20     1    22     9     1 
   21     4    17     3    17     9    13    24    24    14    13    18     4    17    18    25    18    24     3 
   17    14     6    17    11     7    20    12    20    23    18     3     8    15    23    16     4     3    15 
   21     3    22    11    12    13    12     8    19     1    10     7    24    12     3     1     8     7    23 
   13    13    16    14    11     4     3     5     0     8    17    15    14    13    23     2     1     4     4 
   20    14     3     6    17    19    22     9    16    16    12    24    21    11    22    16     7     6    14 
   23    25     4    12    16    24    24    11    21    13    12     3     1    13     2    16     3    23    18 
    6    15    16     2     7    16     5    18    23    15    14    15     3    24     1    13    24     7     0 
   16     2    20     1    22    24     6    14    16    23    23    25    18     0     2    15    14    19    20 
   13    13    21     9     5    24     1     7    22    12    19     1     7     0    16     3     2    21     9 
    6     1    13    20     9    10    15    22    12     2    25     2     3    10    14    12     4    14     3 
   11     4    23    10    16     5     7     0    17     9    15     1    21     2    19    11    19     4    24 
   22    12    15    20    20    20    21    14     5    24    20     9    22    20    17    14     7     7     8 
   22    18    20    15    21     0    15    20    10    21     2    11    20    23     5    22     0    17    20 
    3    21     1    19    19     3     0    14     9    11    20    23     7    15     4    11     5    18    23 


    3     1     1     5     8     6    19    16     5     5    20     7    24    20    19     3    24    15    23 
    2     3    17     0     0    14    22    15     3    10     2    13    11     1    20     5    23     3    20 
    4     1     8     3    13    14     5    21     7     3    18    19     0    15    22     1     1    23    17 
   10    17     0     7    20    24    22     6    11     6     9    12    12    24     6    23    14    16     8 
    6    10     6    12    17    21     1    14    23    15    17    13    15     9    14    18     9     7     5 
   14     5     0    17     0     5     9    24     3     8     1    13     5    15    20    25     7    15     5 
    1    19    12    23     6    24     0    20     5    17    12     5    18    11    19     4    16    10     1 
   15    17    13    11    10     7    13     7    10    15    25     4    16     7    19     8     4     9    16 
    9     7    18    14     7    25    22    25    17    12     5     9    21    18    21     2    12     8    12 
   13    10    19     7    11     9    21    20     8    17    19    15     0    10    12    23    18     1    13 
   14    25    20    14     8     2     7     5    17    20    25     3     4     3    15    18    24    11    24 
    8    21     0    16    21    25     6    23    17     3     7    22     4    17    22    17    20     7    19 
    9     1    18     3     5     3    24     6    13     4     9    16    17    16    22     0    23    16     3 
   10    16    13    24     8     6     5    12     9    17     4    15    25    14    15     3     8     1    24 
    9     0    20    10     7     7    12     2     3     9    13     4     8     1    12     2    23    11    24 
    5     6    23    12     4     2    16    22    15    12    20     4     4    22    14    23    13    16     4 
   14     5     7    16    22    23    23     2    12    25     7     4     4    17    11    15     1     0    10 
   18     0    21    24    18     2    21    24    23    18    18    23     1    17    17     1     5     6    17 
   10     0    19    16     2     9     9    24    20    11     4    10     7     6    22    13    16    10     6 


    6    17     1     4    16    19     9     7    16     7     2    10    23    13    22    10    11    24    25 
   22    17    19    22     3    10    14    19     3    23     6    20     5    13     6     0    18    18    24 
   22    19     1    24     5     8    25     8     1    18    24    13    17    19    18     2    19     5     9 
    6    10     1    24     6     2     7    22     2     1    13     9    21     6    19     2     2    15    10 
    4    14     7    19    25    11    15     7    21    24    15    14    20    12     9     5     4    22    22 
   12    21    16     1    18     4    18     5     5    19    24     6    11    13    12    20    20    19     1 
    6    17     7     3    12     9    25    12     5    17     4     8    17    19    23     6    19    12     5 
    0    22    11    25    22    13     0    14     5    22    21    24     9    15    15     1     9    14     5 
   18    15     9    19    18     6     3     2     1    17    16    25    15    16     0    11    22    25    19 
    1     3    24     2     1    25     4     9     8    11    13     1    13    13     3    11     3    24     0 
   20     7    22     9    12     6    10    18    11    11     8    19    24    14    24     3    16    11    11 
    7    18    13     8     1    17     9    12     9    13    12     5     9    10     7     8     2    16     2 
   21     2    23     9    20    15    23    12    12     8    12    16    23     5    21     7     9     4    16 
   25    17     6    11     2    23     7    25     6    25    13     3     1    10     1    21     5     0     1 
    3    11     4    25    24     4     4    22    13    19    21     1     8    15     3     0    17     8     0 
   10     2    18    23    14    22    25    21    12    21    21    10    11    19    10    25    12     0     3 
   22    24    11    21    21    22    14    25    10     3     6     0    17     2    12     3     9     3    13 
    7     9     7    12    10     8     2     5    15    17    12     3    22    16    22     6     9    16    10 
   16    12     6    25     6    20    22    17     1    15    22     5     4    13    13    10     0    13    10 


   22    20    12     6     4    20    13    19    20     4     5     3     1     4     6    22    20     5     9 
   21     4    19    25     4    21     5    16    21    13    11     4    13    12    16    10    24    10    22 
    4     4    13     4    11    24     4     0    17     8     1    17     9    14     2    10     7     4    23 
    6    21     6    10    19    23     0    25     9    23     6     3     9    16     4    14     0    20    17 
   19    25    16     4     0    21    24    17    12    21    14     7    22    18    22     2    22    19     5 
    7    20     6    23     3    22     7     7    19    25    21    12     0     4    21     5    17    15    17 
   10    14    24    19     1    14    23     6    16    12     2    19    22    15     5    24     3    24    22 
    4    15     1     7     1    16    18    13     8    20    14    23     6    18    10    15     1     8    10 
   25     7     3    14    11    16    12    12    15     8     0    22    13    24     7    24    10     8    11 
   21    16     6    11    18     5     0    16    24     5     0    13    25     6     0    13    14     5    14 
    0    11    23    22     5     3     4     1     0    16    19    16    19    10    16    13    22    22    16 
    6    15    13    13     5    10     3     5    19     9    13     1    23     7     9     6    17     7     4 
   24    12    15     8    13    21    10    10     7    19    24    21     9    21    23    19    24     9     0 
   23    21    19    19     5    10     3     3    14    24    15    10    25    22     0    18    14     0    25 
    8     6    10    10    25     1    20     1    11    24    19    11    24    15    25     6     0     7    14 
   17    17     4    23    16     1     1    18     2     3    16    25     8     2     5    17    15    17    13 
   22    22    14     5     2     2     5    18    11     4     6    14    22    18     0    19     6    15    22 
   24    12    12    13    15    16     1     9     0     7    16    21    19     1    17    13    22     8     1 
    4    11     9     9    18    16    12    18    25    25    13    13    20    12    18    24     5    19     3 


