    7     8    23    21     3     8    10    12    19    23     4    17    23     5     9    22     5    12    20    24 
   25    25     6     8     5     3     0    18    13     1    12    11    18    16    10     5     3     0    10    23 
   22     6    25    11     1     0     4    11    22     8    14    23    16     0    17     6    23    15     1     8 
    3    11     0    12    20    17     1    19     5     7     8    24     8    21    12    14    18    17    16    20 
   15    22    10    23     9     3    16    14    19    17     7    20     5     7     5     7    18    22    17    19 
   20     0    24    23     1    14    14     1    20    10    23     6     9     2     0     3    18    10     6    25 
   20    14     8    13     0    24    12     9    23     4    23     6    14    19    16     4     6    15    11     8 
   15    17     2    10    22    11    11    15    14    15    10     8    18    13    21    19     8    24     6    18 
   15    15    10    25     5    20     1    24    22     4     2    25    18     2     1     3    12    14    11     5 
    3    22    17     6     0     2     0    16    12    21     0    20     0    22    20     5    15    18    24     8 
   23    20    14    24    17    13    14    15     4    16    10    17    10    16     7     3     5    18    14    25 
    8    11    25     6    15    10    24     9    20     3     6    18    25    24    19     8    22     7     4    21 
   20    14    14     0    25    22    11    24    19     1    20    20    12     1     4    10     7    13    21    21 
   13    19     0    16     0     4    18     9     2     4     0    12     9    14     9    11     9    14    19    15 
    2    23     4    17    20    24    15     1     6     7     1    14    17    17     6     3    16    25    17    21 
    2    24    24    22     1    22    13     9     3    10     4    20    11    20     9     0    17    17    14    14 
   19    24    15    19    17     3    12     6    14     3    10    11    13    22    15    12    25    11    22     1 
   22    12     6    16     3     2    16    21     7    14     7    16     9     8    19    20    16     1    21     4 
    1     4    18    24     2     0     4    18    13    15    25     1    22    13    23    21     0     8    16     2 
   16     4    19     2    19    19     1    17    23    18     9     5     3    25    12    20    20    17    22    20 


   11     4     0    23     3    18    13    10     0     2     4    17    20     7     2     2    14    14     7    18 
   14    17    10    13    25     8    21     4     4    14    17    16     5    10    18    24     7    17     0     4 
    5     4    15    23     3    22     9    14    11    10    12    19    12    18     2    22    15    13    13    22 
    8    19     6    19    22    13    14    20     0    21    23     8     5     7     8    20    13    13     9     2 
   23    12     3    18    10    14     6    14     8    13    20    19     0    19    14     8     3    18    12    24 
   15    19    12    19    20    18    11    21    13    12    18    20    25    25    21     8    15    21     4    12 
   20     8    20    22    11    12     9     1    19    12    20     4    22    15    19     4     5    13    19    23 
    8    14     7    21     7    14    19    12     6    18    17    16     4    23    21    18    17     5    16    17 
   20    11    20    13    12    21     1    16    21     4    18    24    18     8    11    16     1    22    16     3 
    9    13    24    24     0     4    17     8    10    11     8    22    22     3     3    13    20    11    22    13 
    3    23     3    17    18    22     7     5     9    13    21    13    24    16    10     5    20    11    17     6 
   22     8     3     1    23    20    25    11     8    12    22    16    25     8     5    22     4     8     8    15 
   22     1    13     3     7    15    17     6    13    15     1    17     6     2     4     6     4     3    17     8 
   10    11    10    11     4    14    24     8    24    24    14     3    23    16    18    16     1     1    17    15 
    8    15    17    12    10     8    18     8    17    23    24    13     3    11    16     6    12    10    12     9 
    9     5     2    13    15     6     6     8    14     7     5    16     3    10    11    10    21     5     6     4 
   11     1     5    19    23    10    18    12    10     2    21    16    17    11     4    12    21     0     6    20 
    8    18    24     0    23    13    20    20    20     0     1     3    21     5    11    11    20    13    22     3 
    2     3    11    12    13    14    19    14    14     6    13    23    16    21    23    17    10    16     1     3 
    7     7     6     1    21    15    11    20    17    12    11     4     3     9     8    18    17    21     9    10 


    3    21     4    12     7    12    10    18     4    14     5    21     7     9    20     4     3    24    12    15 
   11    20    11     4     4    18    11    12    10    16    16    21     3    10    16    24     3    18     3    11 
   10    13    11     4     2    13    16     9     0    21    20    24     3    25    15    20     4     7     1     5 
    3     3     0     5    20     2     6    25    18     9    15     7    25    17    19    19    14    19    21    23 
    2    15    11     3    16    16    22    24    14     5     7    11     8    14    14     2    17     2    19     9 
    3    12    22    14     6    15    13    23     3     7    20    12    19    24     9    12    13     0     9    13 
   16     2    12    17    11    10     2    23     5    24    20    19     5     1    16     4     5    22    23    14 
   20    22    18    21     2     1    13    10     3    25     3     0    11     0    11     0    13    18     1    19 
   25     8    19    25    24     4    15    25     3    16     3    17    25    11    13     8     1    17    13     0 
    8    12    11     9    18     2    13    20    10     1    13    19    15    13    12     1     9     4    20    11 
   18    24    23    13     3    13    24    12    14    25    15    25     1     9    24    19    10     4    20     7 
    3     0    21    14     3     2     7     6     8     8    19     4     8    12    25     3     8     5    15     3 
   18    13    14    24    10    11     2    10    17    20    13     5     0    12    17    13     1    24    24    13 
    2     7    25    19    21    17     7    13     4    20    11     5    25    16    17    11     6     3     4     5 
   19    21    12    15    12    13    16    16     6     5    15    16     3    19     6     6    18     0    12    25 
   25    20    16     6    15     8    22    14    16     4     8    14     1    25    10     7     8    22    11     9 
   16    16    15     3    21    22     0    24     3    15     6     9    17    20    11     4    10    15    19    17 
   10     9    11    13    22    17    14    11    10    24    13    24    22     4    10    24    13     7     1    18 
    4    12    13    18    16    12     2     5     0    15    23    13    25    16     2    23    17    22     1    16 
   20    22    10     6    14    20     1    13     3    16     5    12     7    21     9     3     5    13     6     1 


   20    17    19    16    16    23    16    20    20     5    25    12    23     6    18    20    21     5     2    19 
   21    18    14     1     1     9    25     5    18    16    25     1     1    10    12     8     0    23     9    25 
   14     8    16    17    13    15     8    18    11    18    15     4     6    12    24     7     9    19    18    17 
    0     7     1     5    22    14     2    11    23    18    23     2     7     2    10    16    13     4     1    23 
    6     2     3     9     9     2     1     9    12    21    15    18    24     0    21     9    14     1    25    12 
    6     1     5     2     9     3    22     8     8    24    20     0    22    19     9    24    25    11     8     7 
   14     4     6     4    19    12     9    15     2     7    14     2    19     0     8    25    20     5    17    14 
    6    14    25    15    21    12     2    23     8     0    18    21     6    22    13     5    24    25    12    13 
   22    25     9     0    12    17    25     1    19    14    20    21     0    15     5     8    15     5     3    21 
   19    22     2    16     0    22    22     5    24    21    24     2     8     9     3    25     7    15     8    17 
   14    14     0    10     6    23    11     8     2    11    16     1    20    12     1    11    14    20    18    25 
   16     2    18     3    19    18    10    17    17    23     3    25    14     4     9    11    14     2    15     6 
    9     2    25     7     8    13     8     6     2     4    11     0    11     3    25     3     8    19     8     2 
    6     2    20    12    21     0     1     0     1    10     7     9    12    20     0    17     8    22    13    20 
   15    21     6    17    24     6    23    20    15    19    19    20    11     1    20     2    19    25     0     4 
   18    13     8    22     2    10    17     2     1    21    20     0    17    16    13    13     0    12    16    15 
   18     7     2    11     0    25    12    13    18     9     5     3    19     3    16    25    19    18     8    18 
   14    21     3     1     6    13    16    16    21    19    24    22    20    13    13     3    22    23    14     6 
    0    18     8    16     6    25     1     5    18    21     5    20     0    12    20     4    14     6    19    13 
   23    15    12     2     3    20     9     3    23     3     0     3    25     6    16     3    25    23    23    25 


   21    24     3    21     2    16     2     4    14     6     3     8    24    12    21    14    20     3    22     0 
   15     5    16    24    16    16     8    23    16    15    14     9     4    15     1    16     2    22    25    16 
   15     7    15     1    11    18     9     0    17    13     6     4     2    16    25     6     7    17     0    25 
   25     3     2    25     5    11     5    15    17     1    16    10    10    20     1    20    22     3     2    24 
   10     1    17     5    21     7     6     0     1     9     4     6    11    22     5    18     6    20    19    13 
   16    25    16     4     4    24     2    18     8    23     5    19    15     0    14     4     8     6     6     2 
    5    16     2    12    14    13    18    20    16     3     5    13    18     4    17     4    16     5     1    16 
   14     8    12     0    10    13    15    24     1    10     9    10     9     0     5     2    13    25    23     4 
   17    23     8     6     1    25     4    10     0     1    25    12    10    21     8     8     4    13    16    21 
    7    21    12     4    25     9    13     1     6    24     0    17     7    14     9    17     4    15    24     0 
   19    10     9     4    22     9    14    12     1    16    24    14     5     5    11    14     5    22    19    14 
    3    18     5     2     9     9    12    15    23    14    16    14    12    21     7    13    13    25    20    10 
   14     5     0    15     8    18     3    22     8     8     6    20    18     5     5    15    13     5     8    15 
    9    16     1    22     9    19    25    21     5     2    21    16     5    22    18    16     0    20    21    20 
   19    17    15     5     8    13     7     9    15    25    10    17    21    25    23    23     4     1    15    11 
    6     3    18    12     2    16    13    19     7    19    10    25    11    10    10    21    22    11    21    19 
   23    20    25     6    11     5    15    12    25    23     1     2    24    13    24    11    12     6     2    20 
   24     9    19    19    11    22    10    19    23    18    21    23    18    10     3     8    12    18    11    14 
   10    21    21    22     7     1    22    22    14    12     7     2     0    10    24    21     6    10    18    25 
    6    19     7     7     0    16    18    22    23    17     0    21    18    24     3     7     8     2    19     0 


    8     8    21    16     2    12    21     8     2     9    11    24    17     8    19    12     1    21    18    25 
   10    15    23    25    19    20    17     0     4    18     6    20    21     8     8    24    20     5     1    14 
   23     1     9    20    13    12    17    14    20     5     9    18     9    14     2    13     4    18    17    25 
   20    13     3    24    21     6    18     7    10    20    12    21     8    18    15    14     9    11     6     7 
   25    13    12    16     5     2    22     3     1    24    19     1    19    13    24     0     0    17     7     0 
   13    25    11     0    10     6    16    24     4    16     8    25    24    13    11     2    11     6    16    18 
   21    12     5    21    11     1     5     4     2    10     2    18     1    25     4     9    17    24    18     5 
   22    18    16     7     0    20    13     5     0     9    22     8    20    16     8     1    16    24    12    17 
   22    22     6    11     8    19     1    21    21    11    16     2    12    22     4    11    16     2     5    10 
    3    22    25     4    17     1     1    16    10    21     6    17    19     9    10    21    20    14     7    17 
   19    12    11    11     8     9    22    25    13    24    12     8     4     5    12    18    23    21     2    23 
   25    24    17     4     8    14     3     2     6    17     7     0    17    17     1    20    25    11     9     8 
    0    12    11    14    11    12     2    21     7     3     7    25     7    19    10    18    21    22     3     2 
   20    14    11    23    11    17    23    22    24    15    25    12     5     0    18    11    22     7    18     7 
   12    22     5     1    24    21    23    17     3    10    17     5     0    19    13    13    19    21    11     7 
   24    12    23    11     4     3    19    24     0    16    24    11    20    20     7    13     4     7    16    15 
    1     6    16     0     7    17    18     4    16     7    19    15    16     9     8    13    14    24    14    23 
    7    20    21     9    16     6    16    15     8     2    20     4     0     4    11    21     1    15    22     1 
    5     2    15     2    17    10     1    20    13     0     5    14     6     1     7    23     0    19     7    22 
   23     5    20    22    23    15    12    13    21     0    25    25     1     7     7    22    20     0    22    23 


   22    24    22    17    13     4     8    14     7    20    11    23    18    19    24    10    17     3    24     2 
   16    17    24     4    12     7     4     2     6    12     2     1    13    12     4    25    11     3    12    16 
   14    11    21    14    11     7     2    23    22     1    15     9    15    10     7    16    17     0     7     4 
   18    14     4    22    11    18    11     3     9     9    24    21    24     8    18     5     1     9     0    24 
    6     4    11    19     1    16    19     2     0     3     1     7     1    18    23     7    16    21     5    21 
    4    24     1    18    24     6     1    18    14    18     5    24    22    11     1     2    15    12    17     8 
   12     1     9     6    13    12     2    17     1     6    19    23    23    23     8     8     7    12    18     1 
    4     3    14    25     4    13     5     7    25    11    16     9     4     2    14     1     4    14     9    17 
    3     6    15    20     6    22     2     4    15     1     0    10    21    14    21    18    17    25     3    24 
    6    25    25     0    21    19     2    18    23    19     6    23    18    19     8    17    13    22     1    12 
    1    23    25    18     6     7     9    11    10    17    11     7     5    13    17     8    15    17    13    23 
    5     3    10    19    23     1     6    18     9     7    11     3     5    19    22     3    16    21     0    21 
   12     2     7     5     1    23    17    25    16    23    23    23    24     5     5     2     4    22    24     2 
   24    19     2    17     0    11    23     2    19    21     6    14    16    16    21     3     5     1    23     8 
    5     7    19     5     1    25     2    10    13    25     9    22    24     9    16    12     6     7     5    17 
   15    21     8     5     1     9    11    19    16    11    13     9    12     3    16     3    21    25     3    17 
    8     3    23    18    18    19    21    16    12     8     7    21    24    25    18    11    15     4    15    23 
   16     0     2    23    16     0     3    21    17    19    15    15     7    18    25    17     1    14     8    16 
    1    12    16    15    25    11    23     8    17    17     1    13    11     8    21     4     0    16    18    10 
    7    25     0     7    11    18    11    25    17    15    19    11    10    24    12     6     8     5    24    21 


   18    17    24     0    24    20     4    25    11    18    23    20    18    16    19     0     3    25    15     1 
   14     9     9     9    25     1    12    25    13     0    21    11     5     2    23    22     6     8     8    13 
   24    20    14     0    14    14     6    23     2    23    17    23     8     2    12    10    20     6     1    24 
    6     9    21     1    20    15    12    21     7    23    18     8     1     4     3     1    24    11     6     6 
   10     0    10    22    13    20     6    13     7    24     1    14     2     1     3     3     0     5     5     0 
   11     2     2    13    13    22     2     6     8    14    19    18    10    15    14     2     8     9     0    11 
   15     1    23     7     0     4     0     6    14    12     4    23    24     6     2    14    15    14     9    22 
    8    10    10    18    19    23    17    16     2     1     4    25     8     2     5    18    21    22    13     6 
   21    17    10    24    18    22    22    11    15    18    25     4    23     7    11    15    23    24    16    23 
    6    16    17    20    21    19     7     7     4     2    20    19     2     4    13    15    13     1    21     4 
   19     1    11     5    24     5    13    11    13     3     6     9    20    10    22     4    21     0    15    11 
    7     3    22    25     3     0    18    11     7     0    12    19    19    15     0     2    23     2    19     1 
    0    24     4     1    16    17     9     9    25    10    24    15     6     8    21    18     3     6     8     9 
   10    19    11    12    10     9     5     5     6    10     7    14    12     1     9     6    17    17    23    19 
    4     1     6     6    11    12     4    21     1    17    13    16    22    15     1     9     5    21    11     9 
   15     3    24    21    14    13    18    12     8    13    24    14     6    12    18    19    12    24    23    20 
   11     6    25    21    24     4     8     1    12     4     9    18    20    20    13    16     6    24     1     3 
   14     8    10    20    16    12     9    24    10    12    17    22    22    11    20    15     3    17    14     3 
   22     5    22     2     6     7    17    17    15    10    14     5     9    13    20    21     2     6    13    12 
   25    23    22     0    16     0     0    19    20     7    11     4    19    20    18     3    13    20    13    14 


