    5     7     8     9    23    10     2     9     5     5    19     5    18    14    25    15    20    18    23     8 
    4    10    11    19    21     0    11    24    18    17     3    10     6     5     2    12    22     4     9     5 
   17     5    23    20    15    12    21    23     4    14     7    15    15    20     0    16    21     0    15    20 
    9     4    12    11    17    23    23    16    10     3    24     7     5    17    11    12    12    11     2     0 
    3     6    11     6     0    15     9    16    18    14     8    13     7    19     2    17    11     6    11     4 
    1     8    19    16    24    25     6     7    21    24    23    20     9    19     1    16    23     0     6    21 
   22     5    16    21    17    11     3    18    19     5     5     6    23    24     2    16     7     7    19    25 
    1    21    16    12    10     3    13     9    10     8    13     1    25     3     8    16    13    16    10    13 
    6     1     3    24     7    20    12     8     0    12     3     5    21    14    19    12    19    23     3    13 
   25     3    15    17    12     4     9     7    25     7    19    22    15     2    21    11    13    14    23    21 
    8    16     0     5    15    21     4     3    20    12    16    23    20     3    12    13    21    17    10    15 
    2     0    11    12    17     9    21     0     9    22    11     0     5    17     3     6    14    23     1    11 
   18     2     3    17    20     5    13     6    17    15    20    18    11     0     0     2     5    12     6    17 
    8     5    19    21    24     2    11     6    20    19     3    13     8     4    21     0     6    10     0     0 
   18     8    15    24    18     5     9     2    19    12    12    12     8    11     6     0    22     1    19    22 
    7     0     2    23    20    15     2    12     1    23     1    21     6    20    15    10    22     3     7    16 
   19    18    17     6    10     8    18    10    21     6    15    12     0    24    10     6    11    18    22     6 
   23    19    17     5     1     1    21    15    21    11     7     8    19    23     0    25     9    11    22    23 
   11     7     5    14    24     3    16     3    18     9     8    23    21    18    18     9     4    16     2    10 
   24    19    19    16    24     2     5    20    18     4    17    16    20    17    19     2     2     6     0    17 


    4    19    22    18    14    18    13    24    20    12     7     1     1     0    11     1    24    22    18    23 
   24     8    13    20    17    16    16    17     7    11    15     6     6     5     3     0    13    18     5     0 
    9    12    11    19    24     8     8    24    10    23     9    25    14     9    16    16     7    25     3     0 
   17    15    14    19    13     2    24    18    24    23     5     2    16    24    23     0    20     4    25     9 
   10     6    20     0    22    17     0     6    15    18    12     5     5     9     0     0     2    18     6    14 
   22     9    23     4    12    15    13     9    23    20    20     2     7    23    17     1     3    20    14    23 
   13    23    10    11    15    12    12     8     0    16     4    17     0    14    23    25     5     8    13     9 
   25    18     1    25     1    20     9    14    15     0    12    25    23     2     8    16    18    24    25    21 
    2     7    19    15    15     0     3    22    23     8     2    22     6    13    25     2    16    13    11    14 
   24    14    11    23    11     0    14    14     8    20     1    22    16     9     6    25    21     5    20     3 
   22    14    24    23    11     8    13     8    15     7    12    19     2    20     0    24    12     0    22    14 
    9    20    19     5    24    21    18    14     7    23     6     1     0     1    19    13     6     7    21    17 
    9     8     7     3     2     4     2     4    13    12     6     8    21    16    21     6    11    22    25    10 
    0     4     3    17    11    13     0     9     8     8     3    17    15    22     9    22    12    15    16     9 
    3    20    22    24    15    21    18    13     0     0     4    24    13     3     9     2    17     6     9    20 
    9    14    20     1    23     3    11    21    14     0     7     2     6    12     9    20     2    12    12     2 
    4    10    18    24    10    20    19    10    23    25     2    16    19    12     2    16    23    10     5    23 
   15    16    25     9     0    14    16     3     8     9    22     3    12    13     8     1    15    11    16    16 
    7     5     5    11     8    23     5    17    21     1    24    15    24     0    23    10     6    24    23     7 
   24    24    18    25    18     2    14    20    17     7    17    25     6     5     5    14    23    14    13     4 


   25     6     4    15    14     3    22     3    17    10     1    25     1    15     4     9    19     0     0     5 
   10    25     6    17     9    24    23    15    16    10    20     7    10    20    10     9    23    19     3     5 
    6     8     4     2    10    15     9     6    11    14    20    15    11     5     2    18    15    19     1    11 
   25     8     4    21    22    11    10    22    21    22    14    25    23     4    22     9    14     7     5     2 
    8    17     1     1     8    11    14     3    22    16     1     9    12     7    23     8    23     0    13    17 
   16    22     8     7    19    22    23    23    13    23    25    15    19     3     3    24    19     6    16    10 
   18    16     4    24    18    19    13    21    25    17     7    19     3    12    21    12    17    14    19     6 
   19     6    14    24    12    18    19     2    24     2    18    23    12     7    20     4     7    11    16    25 
   21     8     4     1    12     6    10    21     3    14    18    16     6     0     6     3    20    16     5     7 
   14     8    12    12    15    11    14     2     3     6    25    22     1    20     0     1    18    14    23     1 
    3    21     1    13    15     6    25     1    14    22    11    15    23     6    24    25    17     7    20    16 
   15    16     2    21    13     5    23    23     1    25    16     5    22     8    23    15     3     8     5     2 
   18    23     2     3     3    19    19    21    14    24     1    22     9     8    12    12    12    20    19     9 
    0     0    12    14    13    19     5     6    15    16    21    22     4     1     3    10    13     2    21    11 
    4    16    12    19    11    17    10    23    12    16    20    21     5    17    14    11     9    11    21     1 
    6    11    13     4    24     3     7    14     2     3    19     2     7    18    14    23     6    16     8    20 
    9    10     9     1    13     6     6     5    11    22     6     7    25    16     7    24     5     7     1     5 
   19    21    25    10    10    17    25    17     1    11     7    10    25    23    21    25    13     2    13    18 
   17    23    11     8     2    23    13     2     6     2    10    24    19     7     6     2     2    10    15    20 
   20    18     0    25     1    12     1    15    19     1    15    16     5    14    13    10    23    25    23    22 


    1    14    16    11    16    22     7    20    23    20    15    18    24    16     7    13     9     4    12     1 
   18    13    10     8    24     7    24    25    18    17    21    13    11    24    11    19    17    22    24    17 
   15    23     2    21    13     6     3     4    21    22    21    17     8    17     6     5     6    21     2    18 
    7    24    20    11    14    11    16     7     2    16    23     7     2    11    17     1    19     9     2    21 
   12    17    10     7    12    15    25    24    17    22    24     7     4     4    25     6    16    15    22     6 
    2     8    14    18    14    20    24    12     9    13    17     2    17     5    13    21     7     8    21    23 
   23    10    20    15     3    19    16    15    17     0    11     1    18     0    16    16    22     8     4    10 
   22    20    13    20     3     9    24     0    19    15    25    22     8    14    17    20    25    11    25     0 
   15     5     7     4     1    10     8     2    20    16     5    10     8     5    16    12     6    11    10     9 
   12    11    11    22    13     2    15    10    17    13     9     1     5    19    13     2     1    20     1    15 
    9     2     3    11     5    24    16    24    14     5    15     2     2     0    23     4    16    25     8    24 
    4    15    12    25     2    17     7     8     3    21    21     0     9     8    21     3    16    23     7    19 
   19    22     9    22    24     4     7    20    16     5    17    20     0     4     9     8    12    13    17     4 
    9     6     3    10     3     0     0     9     5     3     4    14    21    13     8    24     8    18     9    11 
   22     5    18     7     1     3    14    24    11    14    17    19     5    22    25    14    10     7    11    15 
   10    25     1    22    12    13     0    22    12     7     8    15    21    10     5    22    19     1     3    21 
   14    19     7    18    10    22    18     3    16     3    21    22    21     5    16    18    23     6     0    13 
   19     1    15    22     5    11    21    20    11    15     4    11     0    13    21    11     4     5     2     6 
   24    11     9     6     8    19    15    20    10    16     2     3    23    14    13     9     8    11    14     5 
    5     2     6    23    23    21    22    22     7    16    16     6    12     8     7     5     5     6     7     5 


   12    18    20     5     8    14    18    23    13    15     4    22     1    19    20     2    15    15    16    20 
    0     5     1    14    20    17     4     2     4     8     3    14     1     3     4     5     3    21     9    22 
    0    16     3    17    14    20     9     3    12    15     6    21    23    23     6     9    24     2     1     2 
    6    17    19    23     3     5    11    13     8    23    15    25     3    10    20     8    24     0     2    19 
    7     7    21    23     4    10    15    22    15    12    19    10     6    14    22    15    18     2    12     1 
   16    22     0    19    10    14    24     1    17     0     3     4    10    12     6    24    16    18    12    11 
   10    24     0    16    14     7    22    16     5     2     3    17     6     4    12    25     1    20    18     3 
   17    25    25    10     5    17     2    14     0    11     1     1    21    19     1     2     7    23    25    25 
   23    19    24     3    22    13     7    21    15     2     8    23    10    14    11     9     8    16     1    16 
   14    12    14    11    20    17    25    13     1     2    18    13    17    19    25    20     1     0    13    10 
   23    24    22    17     1    22     3     6    24    23    24    20    25     6     3     5    16    18    12    18 
   10    22    10     0     3    11     0    11    20    22     9     9    19    23    18    11    19    17     3     4 
   20    14     9     1    24     8    16    18    22    19    20     6    20    24     9     3    13    11     6     8 
    4    16     2    23    11     3    14    11     5    13     0     8    20     1     7    11     8    16    10    16 
    2    12     3    25    11     9     1     3     9     3    14    21    18     2    24    22     6    12    14    22 
   16    25     2    20     2     5    19    20    17    18    23    23     9     2    21    25    23    23     1    10 
    2     3    13    24     1    14    22    19     2    18    16    23    12    21    15    23    25    24    15    17 
   12    12     5    20    22     6    14    11    24    14    10     9     3    18     5    24    15    23     8     3 
   16    22    13    15    15    17    16    23     5     6     9    15    18    13    23    19    16     8    11    19 
   24    12    23     8    14     5     8     5    16    22     9    15     3    22    18    18    25     5     8    17 


   17    20     4    13     4    16     1    20    12    18     0     0    21     0    17     9    17    12    25    23 
   25     2    24    20     7    14    12    17    18     5    15     7     4     4     4    18     0    23     7    13 
    4     0    24     0    17     5    25    12     9    11     5    22    15     8     6     9     8     1    20    11 
   24     1    19    16    15    17    18     4    15    12    24     5    12    17     9    21    20    25     1     6 
   18     4     4    19    11    18    15     7     8    19    20     4    24    15    19    17     9     2    16     0 
   22     8    19    23    20     1    22    18    11    15    24     8     8     0     6    11    11     4     6     7 
   23    19    21     3    16     5    12    15    22     4    16    14     7     5    13     1    24     2    11     2 
    5     3     5     0    14    19    24     2     8    15    12    15     8     1    22    20    15     6    22    12 
    3    18    11     4    15    11     7    11    21     9    21    11     9    15     9    13     0     5     9    11 
   20     0     9    17    24     7    12    10    16    12     5     0    12     0    25    21     5    10    14    12 
   10    21    11     8    11     1    21    11    17     8    14    18    16    19    23    15    18    17    11     2 
   21    23    15    21     4     7     4    22     6    22    16     8     4     3    10    20    11     6    16     1 
   17    24    11    24    18     3    16    10    13     1    10    24     8     2     4     2    13    18    19    23 
   22    17     5     7    18    24    14    15    11     8     0    22    16     2    16    15     9    19     6     4 
    5    12    12    21     6    23     8    19     7    21    17     3    25    10    20    25    13    10     4     8 
   12    13    23    22     1    14    21     5     7    11     3     1     9    25    13     1    16    25    18     8 
   22     9    20    23    16     9    22    25     1     0     2    18     1     8     5     1    14     2    16     3 
   21    11    21     8     3    12    11    24    17    21     8    24    12     6     0     6    22     8     1     7 
   21    17     0    21    24    18     9     7     4    18    14    11    24    12    15     3    22    24    19    20 
   19    19     5    22    19     8    21     4     4    23     7    15     4     1    19    20    12    11     3    15 


   17    18    17     5    18     0     2    25    13    23    13     2    16     9     1    15     6    12     7     0 
    6    19     6    17    17     5     8     7     9    15    11    18     9    19    10    24     2     4    22    15 
    5     6     5     5    18     9    25    13     1     3    13    12    25     1     7    17    24    21    23     8 
    3     0    11    13    12    21    22    15    13     6    23    15    18     2     6     0    14     3     6    20 
    9    22    12    24    24    15    22     6     0    24    23    13     3     5    12    22    20    24    19    14 
   17    11    25     5    21     5    14     4    19    15    16     3    17     7    22     4     3    22     4     6 
   21    24    24     9    22     1    10     8    23     4     5     8     4    17    20    21    25     2     6    16 
   21     0     7     2    12    24    13     8    23     1    10    14     9     2     9    11    19     3    16     9 
    2    19    22    18     6    15     1     4     3    14     1     5     5    16    15    11    21    19    20     4 
    9    23    21     4    24     3    17     4    17    13    14     2    15     5    21    25     3     3    18    17 
   15    18    23     5    22     9    15    19    13     3    19    15    18    23     3    20    18     0     7    17 
   13    13     4    11     9    18     1    16    20    24     3     3    20    16    20     3     6     6    11    17 
   18     9     0     8     0    23    20    18    24    22    19     1     3    13    15    10    22     7    17    17 
    9    10     6     5    24    11    22     0    14    13    18    10    16    23     1     1    21     5     5    11 
    2     3    18    11     4    18     1    15    19     1     1    23     4     0     6     6    12     6    12    18 
    6    19     6    24     8    20    20    24    18    11    18    18    24    15     9     0    22    10     9     5 
    8    16     0     7    22     6    24     7    25    18    17    12    17    15    12     2     0    20    14    20 
    2     4    24    12    21     4     3     5    22     4    21    17    18    21    13     3     0     1    15    16 
   17    21    22     9    25     7     7    19    10     5     2     5    22    13    17     9    21     1    13    13 
    7    23    15    24    16     9    17    16     4    20     5     5     3     7    12    14    25    22    11    12 


   12    14    13     8     5    18    20    16    19     0     6     6    23    18    14    18     5    14    24    15 
   22     5    19    11    14    25    11     2    20     5    25    21    23    11    18     3    18     6    11     1 
   12    18    19    12     7     8    14    19     1    24    10     8    19     1    25     5     8    14     3     6 
   13    13    18    20     5    23    14    13    23    19     2    12     8     6    14    16     7     8     3    19 
   11    25    12    20    14    22    15    16     8     5    23     8     6    10    19    19    23    24    12     1 
   12     8    20    18    14     9     4    22    15    14    12    25     5    14    11    16    21    23    25     7 
    1    13     8    20    21    23    15    15    20     1     4    17    16    13    21    14     2     7     8    13 
    3     2     8     0     4     8    20     2    11    18    11    18    22     8     5    11    25    13    11    16 
   24    10    16     1    10    18    10    19    12     7    22     7     0    18     3    21     9    23    17    11 
   11    14     1     1     3    16    12    17    24     1    12    11    10     8     5    24    10    10    16    24 
   22     3     8    23    12     1    25     9    24    18     0    20     6     9    17     5    10    15     3    16 
    5    21    12    25    21    10    22    24     0     4     0     4     9     2    15     3    24     3     0     0 
   10     1    13    10     9     9    19    17     1     5    17    25    17    10    10    10    12    21     6    12 
    8     6    17     3     2    25     2     0    17    20    14    17    23     4    13    19    17    22    20    21 
   20     5    23     7     1    11    23    20    21    17    22     5     9    23    22     3    15    22     4    11 
   25    17     9    23    18    24    13    13    24     1    19     6    18    17     5     5    16    11    18    24 
    8    10    12    17     3     6    12    15     8    21    14     6    10     9     1     5     3    25    19     8 
   13    20    24     7    19     5     7     1     4    22    21    23    22    13     0     0    14     4     2     5 
   15    13     6    24    23     1    18    12     5     0    17    17     2    16    21     7     4    21     1    15 
   10    24    12    17     8     9    11    13     4     7    23     1     8    22    22    11    18     5    20    25 


