   11    10    19    17    12     7    13    21    19    21    18    24     3     2     6    18    18     5    14    11     7 
   24    21    10     8     6    20     6    10    12     3    17    17    19    17    15    20     2     8    19     2    20 
   23    25    14     0    22    21    20    14    20     9    18     0     6    12    21     8     4    17     7    10     5 
   25     2     1     9    25     7    16    13     3     9    15     7    24    12    17    21    14    18    24    11    15 
    5    13    13    12    22     0    19    15    18     1     4     7    25    15     2    22    10    20    16    16     1 
    1    17    10    21     0     6    16     6    22     9    14     2     4     7    24     3    24     1     9    22    17 
    1     7     2     3    25    14     9    19    24    19    24    21     8    12    15    13     6    15    14     7    10 
    1    20     3     0    11    25    16     7    11     8    22    18    25     0    22    18    15    18     8    21    20 
   14    18     9    10    15    20     3    21    18    16    14    12    18    11    17    21    25     2    24     1     2 
   16     2     0    14    19     4     0    24    19    14    24    24    25    11    12     6    15     4     4    24     3 
    4    21    21    16    22    25     1     8     1     3    14    17    20     9     3    16    13    12    17     4    13 
   23    10    20    10    22    19     4    16    22    23     1    11     8    17     5    14     6    19     7    16    16 
   17     5    22     5    13     2    23     3    25     6    25    12     4     7     5    23     2     1    12    11    14 
    0    14     9    14     6    17     7    21    23    21    25     2     0    11    16    15    22    10    17     0    22 
    9    15    15     8    11    10    13    19    24    16     1     2     4    11    14    24    17    18     7    22     0 
   25    13    19    11     1     9    18     9    11    16     5    17     2     2    23    23    18    25     4     8     1 
   21    23     1     2    15    24     5    24    15    11    16    16    10    15    19     7     5    16    18    24     9 
   13    18    13     6     2    12    22     6    12    18     7     1    15    10    12    14     6    19    16     4     0 
   16     4    23    16    16     4    23    19    15    11    23    22    16    10    12    11     0    15    13    18    14 
    9    10    10     9    15    17     8    15    22     6    15    21    24     9    20     6     5     0    14    18    10 
   21     0    15    18     5    23    25    22    10    18    16    19     5    17    16    14    21    17    16     7    16 


   16    24    12     3     9     1    25     2    17    20    23    11    20    14     5    18     0     8    12    25     8 
   18    17    17    16    17     5     9    24    10    25    19     5    12     3    14     2    17    25    25    12     6 
    7     7    19     0    22    11    17    18    23     9    13    19    11     7     2     4    16    17     6     4     1 
   14    16    16    19    16    20     0     4    18    15    15     5    17     0    14    11     6     3     2    15    21 
   19    18    12     5    11    24    21    11    21     0    15     5    14    18    23    14     6    20     6    14    17 
    8     8    24     9    25     4    18     7    16     7    22     2    14    19     5    10    21    15    23    15     6 
   14    19     9    13    25     5    21    12     5    13    22     8     7    12    14     9     6     4    17    19     1 
    6    15    20     3    19     5    14     9     9    15    14    22     9    21     4    10    12    20    18     9    15 
   10     3    13    24    10     8    11    19    18     7    21     6    14    10    18    23    13     7    13     4    12 
    8    16    13    14     4    12    12     1    19    16    18     4    13    24    25    11     0    11    11     1     1 
    7     0     1     7    19    24    17     9     0     1     2     3     9    12     6    11     2    20    10     0    23 
    4     2    12    16    18     5    23    25     5    19    17     2    18     8    17    25    25    14    20    13    23 
   19     4    19    17    16    17     3    10    14     6    13    13     0    14     6    18     1    19     2    18    15 
   12    15    13     7    14     9     1     4    23     5    12     7    21    22    10    24    12     6    22    12    20 
   20    16    23    15    14    20    23     7     4     6    21    11    21    25     3     4     3     3    20    24    14 
   22     6    11    25     5    13    23    21    11     0    22    17    10     7    15    22     9     3    22     0    22 
   12    12     4    15    12    22    10    22    25    22    25    18    21    22    11    13    21    25    15    21     2 
   24    18    12    13     7    19    15     8     9    25    21     9    24    21    23    15    19    21     7     1     0 
   25    11     7    12    15     9    12    19    25    23    18    17     2     0    15     7     2     5     0     9    21 
    5    19    21     7     4    25     0     2    23     8     0    13     0    20    12    12    21    14     1     1     4 
   21     4     4    14    20     1     4    22    12     5    19    16    19    23    22    22     6    23    19    25    13 


   19    25    10     3     2     7    16     0    23    18     1    19    22    22    14    13    23    25     7    23     1 
    5    20    18    16    23    15    18    21    24    15     8    18    23    22    19    25    25     5    10    18    12 
   22    15     8    14     2     7    10    17    20     8    12    18    19     8    24    11    11    21     3     8     7 
   24    15    12    22     5     8     4    12     4    17    20    11     5    11    14     5    10     9    20    20    13 
   18     0    20     4    19     5    24     5     6    18    14    22    25    24    15    12    21     0    18    15    22 
   14    18     8     3    24    14    18    18    22    17    25    17    15    10    18    21     8     8    24    23    23 
    6    24    18     5     1     6     6    23    12     4    24     3     9     7    11     6     9     8    12     9    18 
    4    18    19    21    21    20    12     9    17    25     0    22     9    17    14    23    16    22    17     3     6 
   21     4    17     7    12     3    18    23    19    20     5    24     2    22     6     8     8    16     1     0     8 
    6    16    11    20    12     0    23     9     2    10     0    20     5     4    24    11    10    23     9    15    11 
    7    11    18     6    21    24    24    23    22    20    20     6     6     4    20     1     6    16     9     2    12 
   16    21    19    10    16    13     7    10     0     2    21    12    21    10    24    16    21    24    25    10    17 
   15    22    12    11    18    14    22    15     4    20    10    16    13    23    15     5     0    14     6     5    18 
   17    13    16     2    12     6     9    13     2     9     8    21    20     4     2    22     8     3    24     2     1 
   21     2     6    14     1    24    25    23    11     4    15    15     4    12     5     4    13     7    24    11    17 
    6     6     7    11    11     4     0     4     9    24    11     2    10    17    13    13     1     0     7    19     3 
    2     8    17     5    19    23     5    10     1    19    13    12    11     7    19    16     5    16    20     9    18 
    1    19    14    22    10     6    25     2    22     1     5     0    18    11    10     2     8     8     0     8    22 
   10    15    24    18     4     7     6    16    10    21     0     5     5     5     1    24     3    21    19     7    13 
   21     9    19    11    21    20     4    21     0    23    15    22    11     1    20    21    13    12    25     8    19 
    6    18    22     6    15     0     5     8     0     7     4    11    21     2    20     4    11    11     3     2    21 


   21     5     3    17    16    23    18    19     4    20    23     9     9    18     7    25    20    24     3     8     5 
    0    24     5     8     7    25    17    13     7    13    12    15    18     4     4    19    20    13    10    24    25 
    9    11    21    15     7    13     0     0    22    23     0     5    14    17    10     3    20    19     8     6    18 
   11     4     7     1    15    19     9    13    21    18    13    10     4    20    16    11     4    16    22    15     0 
   17     2    20    13     4    14    24     6     9     0     4    19    10    17     9    25     9     2     8    24     8 
    2     3    10    24     9     4    24    10    22     3    23    15    22    14    17    17    11     0     7    10     0 
    0    12    22    10     4    18    20     9     2    17    21    14     3     9     1    15    18    10     1     8    12 
   23    20    16    23     4     4    22     5    21     6     4     8     6    13    14    23    19     8    14    22    13 
   11     9    19    17     0    25     7    13    22    20    24     9     0    24     2    21    25     5    14    18    25 
    0     9     1     8    19     6     0    16     1    17     7     3     4    18    18    20     6    11    15    22    21 
   20     8    18    25     2     1     0    18    14    17     0    18     8    24     9    24     1    15    24    12    13 
   14     3     8    25     4    14    19    19    16    21    19    24    21     5    16     2    13     7     7    12     2 
    2    19    22     7     8     3     8    23    17    15    24    19    17    21    11    17    24     8    20    24    17 
   12    13     8     5    19     7     3     5     5    14    25    16    10    13    20    11    14     7     1     2    20 
   13    19    16    12    13    21    12    24     8     9    15    24     9    22     8     2     9    21     7     0     5 
   20     3     6     2     8     5     5    23    20    16     3     8    19     4     8    21    21     8    15    21    21 
    1    16    15     6     8     9    14     9    10     8    24     6    19    24    22    19     0     9    14    11    13 
    8     5    23     7    22    18     5     0     0     8    22    23     3     9     8     6     3    10     8    20    25 
   15    14    23     4    19    14    16    15    20     5    15     9    14     1     1    20     3     2    22     0     5 
   20    12     4     9    10     7    19    13     2    25    23     6    10    16     3    18    24    15    25    25    12 
    5     8     0     9    25     8     4    17    10    11     7    10    10     1     9    14    23    24    13    11    15 


   18     3    20     1    23     7    24    22    13    14     7     8    25    12     1    10     0    11    20    15    17 
    6    15     2    11    10    19     2    12    11    25     7     5    21     9     8    17    18     7    22     2     9 
   19    10    18    10     7     8     4    23    14    10     8    15    24    21    17     7     1    14    15    14    24 
    9    23     6    25    17    18    10    10     2    14    21    15    12    19    14     8    24    15    11     4    10 
   23     0    11    13    19    13    20    18     7     2    12     4     9     3    15    11    18    15     8    21    20 
    0    16     5     2    21    25    21     7    13    21     1     8    10     2     6    15     5    19    23     5     8 
    8     9     8     4    10     1    10    13     9    11    21     1    17     7    17    16    22    19    20     7     5 
    1     5     6     9    21    12     0    24     9    14    19    13    25    13     9     7     1    23    19    19    23 
   10    25     4    15    20    16     6    25    16    17     8    24     9     9    25    18    11    17    14    12    25 
   15    20    19    13    10    14    17     3    16    22     9     9    22     6    10    20     4    23    18     0     6 
    2     0     7    25    10    25     1    14     0     7    18    17    10     4     7     9    17     7    23    16     9 
    1    15    20    15    11     0    17     7    20    11     7     3    22    10    13     4    25    11     9    25     4 
    2     7     4    14     2     0    16     1     4     7    15     5    16    20     7     6    21    23    16    25    20 
   25     9    18    20    14    10     2    22    14     6    20     8    14    19    20     9    12    14     5    25     4 
    3     6    12    11    16    17    13    20    21     9     6    19    21    14    22     7    13    21     7    20    20 
    3    25    10     6    16    18     0    19    19     1    15    19    25    14     8    25    25     1    17     3     6 
    8    15     1    12    23    10     1     9    17    11     8    10    16    18    21    14    10     3     7    20    14 
    4    12    24    24     1    13     0    10    10     1    19    16     7    17    21    23    10    15     6    23    24 
   23    19    14     4    18    14     3    14    22    24    16    16    24     2    10     3    14    24     9    12    19 
   25     5    12     9    18     3    14    18     4     7     5     9     0     5    13     4    19    25    24    15    13 
   18     4     0     4     3    17    21    12     0    19    21    13     1    19    17     5    21    19     8    24     6 


   14    10     2     2    12    19    18    23     1    13     8     6    10     9     6     5    20     0    17    16    24 
   23    20    19     7    22    13     0     6    22     0     2    12    25    16     0     0    10    13    24    18    17 
   12     8    11     1    17    24    13     1    18     6    16    25     3     1    14     4     1    10    21     1    14 
   16    23     6     4    23    18     1     6    15    11     4    16    11     8    17    20    16    25    14    19     3 
   14    15    12    19    17    14    19    12    20     0     4    13     1     5     6    24    13     1     3    19    25 
   16     6     3    10    12    16    14     0    20    18     1     0    22    15     7    11    25    23     2     5    13 
   16     6     8     9    14    17    11    15    13     3    21     0    21    16    24    23    13    24     9    18    25 
    4    24     0    18     5     6    11     0    11     6    10     4     7    13    12    22    18    13     5     3    10 
   11    10    14     3    12    16     9    17    24    16    17     2    19    23    17    22     5    12    16    12     3 
    6    21     5    18    22    17    22    13    24    11    20     2    21     2    14     7    25    24     2    24    14 
   16    13    13     5    22    17     7    11     8     6     7    14    18    20    17    17     4     4     8    14    20 
    5    21    23     6     6    16     6    15    19    14    21     1    11     3     0    22     5    10    18    17    13 
   13    25    13    18    13    13     6    24     2    24    23    19    14    15     2    11     4     5    17     5    17 
    0    23     9    12    13     9    18    21    13    16     7     0    24    23     5    19     7     6     8    22    16 
   10     7     0     5     2    10     9     0     3    24     8    23     7     3    12     5    24     6    10    22     7 
   20    24     8     3    13     9    22     7    17    16     5     0    17    15    16    19     7     3    20    21     1 
   18     9    13    11    16    22     2    14    22     6    15     5     2    20     7    20     0    11     1    16    13 
   19     4    12    13     3     4     2    23    25    13     5     5     0     6     1    13    11     1    23    16     9 
   15     7    20    16    25     4    13     5     2    17    21     6     3     1    24    22    18    11    22     8     6 
    0    25    21     6    11     6    13    18    12    10     8    19     9     8     1     0    25    21    13     1    14 
   17    12    13    16     9    25    14    16    11    10    11     0    16    22     5    22     2     0    23     1    21 


    7     1     6     4    24    24    22    19    15     1    11     9    20    23    21    22    23    11     7     8     4 
    9    17    23    19    15    12    25    17    17     8    17    19     3     8     9    13    24    23    12     6    10 
    3     8    20    20     8     1    24    22     8    24     6    14     8    22    20    16    23    25     2    10     4 
   19     0    13    14    10     8     6    19    21    12    14    24    19    20    14     6    18    25     6     5     7 
   17    13    11    11    16    16    13    17     3     6     2     2     2    13    20    24    10    10    12    23    21 
   22    10    16    10     0    25    12    11     8     0    18    19    13    10    22    14    21    25    11     5    23 
   12    20     4     0    15     2     5    15    24     4    25    22     5     1    18     2     6     0     1     4    12 
   14     2    24     5     0    13     4    16     1     6    21     2     4    20     1    12    24    24    13     1     8 
   12     7     1     2    23    15     0     8     3    23     8    16     2    19     6    19     2    14     8    18    11 
   22     1    19    22    11    12     3     6     8     0    14     5    18    24    17     1     6    23     6     3     1 
    2    21    22     8    16     7     9     9     7     7     6    13    13    20    13    23    13    15     6    11    24 
   15     7     2    16    23     6    15    14     2     7     1    13    18    20    12    17    21    14    17    20    24 
   18    22     6     6    23    15     3     9    17    24    20    12    23    15    14     0     3    18     7     6     1 
    3    11     7     2    11     7     0     0    22     9    12    19     1    23     4     7     9     0     7     1     2 
   15     9     4     1    19     3    23     7    22     2     6    10     7    20    22    18     0    21    18    24     8 
   19    14    24     0    12     1    24    12    20     6    13     2    17     4     6    10     4     1    18     8    19 
   16    18     4     6    20    14    11    23    22    13    25     2    15     7     9    23    13    22     8     0    22 
   23     3    11    19    23    10    14     2     4    10    25    25     8     9    21    24     9    11    21     7    19 
   14    12    24    19    24     9    10    10    24    18    16    10     5    25    17    23    12    20     6     8    21 
   16     1    24    13     3     5    20    24    10    24     8     3     6    16    14    13    14    11    20    21     1 
    7    25     7     4    24    14    11    14    15    21     3     9     2     8     2    14    25     8     5    24     6 


   14     9    14     0    19     3    14    15    25     9     1    10     4    21    10    16    14    20     9    12    18 
    1    23    11     6     3    15    10     5    18     2    23     9    22    25    19    20     7     1    14    17     4 
   22     6    17    21    13    18    19     2    19     8    18    25     4    20    20     9    17    14     0    21    11 
   14    13    21     3    22    14    14    10     5    12     4    24    13    10    13     0    18    12    23    17     2 
   17    17     8    14     1    18     0    20     1    11     1     0     1     0     6     1     1     7     8     4     5 
    8     7     4     4    20    19    12    10    16    11    15    15    14    18    23    20    25     2    22     8     8 
    8     3    13     9    14    14    18    17    17     3    25     5    24     1     3    12    14     0     3    14     5 
   14    16    12    14    21     4    25    25     0    12     0     3    12    19    18     5    24     4     3     0    19 
    6     3    24    14    14    13    13    13    17     1    12    15    21     4    14     8     1    13    10    18    22 
   25     3    18    19    16     7     0    11    20    22    16     8     9    15    14     1    19    20    20     3    10 
   13     1     3    16    12     2    13    23    18    14     8     9     9     5     4    23    24    17     6    11     1 
   15    16    19     9    18    14    21    20     8     6    23     7    22     9    12    17    21     5     1     8     8 
   25    17    20     4     5     7    23    22    14     0    17    23    14    11     2    22    25    21    21    21    17 
    4    18    17    20    16    11    11    13     2    14    17    12     5    17    11     8    19    22    22     1    19 
   10    25     6     2    11    20    21    24    18    15    25     7    18     7    21    22     3    24    18     4    15 
    8    19    17    13    10    11    23     3    22     0    23    17     9    21    19     7    19    15     5     4    18 
   21     3     5     5    17     9    14    22     5    12    13     6     0    15    18     7     9    11     5    16    17 
   15    23    19    17    19     5    12    11    24    24     4     7    19    19    25     3     7    16     8    24    22 
    6    25     1     2     5     2    18    16     1    25    21     4    13    16     8    24     2     8    16    13     6 
   19     6    24    23    21    10     5    13    20     2    23     7     1    21     4     7     9     8    25     2     1 
   14    12    24    22     0    24    14     2     2    18    16     7     9    15    11     4    16    23    18    22    13 


