    3    12    10    16     4    15    14    17     9     3     0     7    12    21     5    16    16    25    18    18 
    6    10    11     3     5    17    15    22     3    15     3     2     6     6     5    16    15     8     8    14 
   25     4     1     8     2    18     4     1    19     7    24     3    24    20    24    23    13    16    17     3 
    4     7    20    10    15     7     6    17    20    24    13    14    15    19     2    18    10    13     9     4 
    7     1    19    19    15     2    13     7    20    10     5    13    19    15     1    15    18    14    25    25 
   21     4     8     0    22     1    12     9    13    11     5    10    10    20    13    18    11     1    17    24 
   12    19    23    13    19     7     5     0     8    12    18    19    13    18     2    24     2    22     0    17 
   16    22     7     6    12    13     7    12     9     7    15    19    23    10    23    23     5    25    21     8 
   19    12     0    25     1     3     7     3    17    24     3     4    19    14     4    22    23     1    10    20 
    2     7     6     0    19     3    13    20    22     7    10    25     0     0    15    17    17    23     9     8 
   12    24    24    12    10    11     1    15     0     5    13     7    14     9    22    11     1     0     9    12 
   21    21    11     5    25    17    18    10     6    22     4    12    12    10    14     0    13    24     6    11 
   25     6    18     7    20    13    19    21    25    25     2    24     3    17    12    10    17    23     5     3 
   15    13     7    14    24    10    14    21     5     0    10     7    18    23     1     7    24    11     9    24 
   13     9    21     7    19    21     3     1     3    12     7     2    20     6    16     1    14    14     6    12 
   24    19     7     9     4     7    11     2    23     2    22     7     7     4    24     2    11     1    22    23 
   23     5     0    12     1     3    13     9    14    23    11     8    21     7     3    11    23    10     2     9 
    6     8     7    11    22     6     5    24    15     3     8     8    20     1     8    11    12    20     7    10 
   18    13     5    12    15    15     6     1    21    23     3    22    23    11    13    22     2     4    24     4 
   12    10    17     6    10     7     6    20    20    18     8    17    21    12     5     1     3     6     8    21 


    8     4     5    15     4     8    20    16     6    23    16    21    12     6     8    21    20    15     1    13 
   22    22     9     9    24    22    12    22     1    25     2    15     2    16     0    15     7    22    19    25 
   23    25    12     9     4     7    17    22    24    11     6    11    25    16     1    20    16     5     8     8 
    2    25     5    21    10    12     7    11    24    17    15    12    23    17     7     5    20    22     5     8 
   10     5    22     5     0     6    25     9    24    25    25     8     5    16     2    18    10    18     4     1 
   18    20    16    13    10    23    18    10    17     5    18    15    24     6    13     2    17    18    13    16 
   25    15    20    18     8     8     6    23     3    10    24     3    13    25     3    25    19    18    21    15 
    7     2     0    24     9    12     5    10    12    17    23     5     8     2     9    19     7    10    15    18 
   12    24     7    11    16    22    11    10    19    15     3    15     5    22    13     1     3    21     8    13 
    2     7     2    20    20     7     8     9    11    20     5    12    22    22     0    25    18    21    10    20 
   20    21    25    19     2    23    19    24    24     7     4    19     5     3    14    16     1     2     0    12 
   16     5     6    19    24    10     3     2     5     6    15     2    18     1    16    17     6     7    12    20 
   13    13    14    20    21    17    21    12    15    24    12    10     2    15    18    10    23    24     2    20 
   12    19     1     8     4    22     4     4     5    25     9    23    25     0     2    11    19    10    20    18 
   23    24     2    14     4    25     1    13    23    18     5    11     0     0    25    18     9    18    23    19 
   10     9     9    11     4    17     9     1    24     6     9    21    23    10    21    13     4    10     5     1 
    8    15     7    19     3    22    25    17     1    17    18    20     2     8     4     1     1    21    13     2 
   24     2     7    19    10    14     8    25    15     3    10    24    17     0    14     4     3     4    19    25 
   23     9    13    13     6     3    10    18    12    24     4     2    22     9    11    17    16     3    25    15 
    1    10    16     5    25    11    13    15     6    20    25     0    12    15     4     1     9    14     6    22 


    0     9     9    17    24    23    14    24     8     4    19     6    22     1    16     0     9     0     7     1 
   16     4    12     1    23    23     6    16    16    14     4    17     4     7     3    23    23    21    10    13 
    4    16    10    25    12     2    22    25    23    11    22     5    22    10    20    23    12     7    24     2 
    6    11    16    20    15     5     9    18     8     3     4    10     5    22    22    19    10     5     4    14 
    8    11    23    12    10    12    12    20     5     7     7     9     0    25    15     9    14    12    19     1 
    2    20    22     8    13     0     4     0     2    11    11    17    17    10    12    14    21    23     4    18 
   12     0    24     4    10    14    17     0     6    22    21    19     5     9     2     8    20    16     9     2 
    6    10     0     9    17    10     3    16    18    15    16     0    15    25     4    17    13    10    23     6 
   17    22    18     6    22    22    22    12    16    20    10    14    18    24    17    25    11    12     1     0 
   22     3     1    24     9     6    16     4     2     7     2    21     9    14    14    22     1    10    19     0 
   12    11     7    15    15    14     2    25     2     5    14    17     7     3    24    22     5    13    11    12 
   16    24    11     8    18    19     7    25    17    24     5    24    23    17    14     4     1     6     7    21 
    9    24    13    10    24     3    15    23    19    22     0    13    18    11    18    25     1    17    10    24 
    0     0     1    24    19     3     0    19    22    25     4     6     8    20    20    19     9    22     8    25 
   19    10     2     0    17     3    17    21    22    21     6    19    20     1    18    21    18    18    10    22 
   19     0    24    20    25    12     3     9    17     2    16    14    21     4    16    18    20     9    14     1 
   16     5     7    17    23    22    24     4    22    13    11    24     3    13     3     3    21    10    25    12 
    2     8    21    18    13    16     0    22     1    17    24    19    15     1    18    18    18    19     0     3 
    7    25    13    17    22     4    21    12    21    16    18    21     0    17     9    14    24     4     7    15 
   23     6    19    23     1     7    17     4     6     7    21    13     4    14    13    12     1    20    22    12 


   17    21    15    22    14    25    13    24    14     9     3     6    21    22     2    10    12     9    13    24 
    8    10    20     6     5     9    25    22     1     8     6    17    11     0    15     7    14     7    18     4 
   20     3     4    18    10    11    20    11    15    10    12    20     7    16     9    22    12    21    16     6 
   10    18     7    16     3    21    24     3    25     4    13    19    16     7    13     4    25     8    13     7 
   10     9     4    17     6    23    16    17    23    13     1    16    12    25    24     7    24     4    13    19 
   21    17    17    16     2     9    24    15    18     5     8     4    13     5    22    12     4    23     6    23 
   16     7     0    25    11    18    24     0     1    15     5    18     4    22    19     7     7    23     1     7 
   16     7     8    16    20    20    16    11     1    18    21    12     1     2    15    13    25     3     8     6 
   20    25    19    22     0    11    18    11     7    21     4     7    21     5     1    14     0     1     3     5 
   18    22    12     1    19    11    20     6    15    10    21     3    24    24    18    14     0    11    10    17 
   19    24    20     7     4    12    13    21    24     8    23    25     2    18     0    11     4     0    25    13 
    1     2    19     7    21     7    13    10    23    16     1    14     6    19    13     1    15     9    25    12 
    9    11    22     4    18    16     0     9    15    20    10     5    21    17     2    17    24    20    23    24 
    2    16     8    15    19     1     1     5    20    20    11    11    23     8    23     8     9     3    10     9 
   17    19    23    19    15     0     9    22     1    17     8     3     5    19     2    16    23     6    24    12 
   25     8    20    21    11    24     0    18    21    16     5     9     8    13    21     9     4    10    14    24 
   11     3     6     3    14     3     3    21    19    19     2     2    25     6     2     1     2    11    25    15 
    7     7    21    10    13     8    21    19    14     1    23    12    25     3     9     0     1    10     4     5 
   19    15     0    25     7    16    13    18    19     8     9    14    24     5    20    21    16    18     4    18 
   24    15     4     1    17    14     5    15    24     8    22    22     3    23     4    24    14    14    10     4 


    7    16     3     0    13    23     7    25    25     7     1     6    19    17    23    19    20     7    23    17 
    4    17     9    24    16    17     9    16    11     8    12    23    10    22    20    10    10     3    10     3 
   15    14     3    11    12    12     0    22     8    17    17    19     0     6    15     0    19    12    24    14 
   15     7     4    11    21    22    21    10    21    23     6    12    10    25     4     5    13    10     4    24 
   23    19    14    21    23    12     9     5     7    22     1    25    12     2     0    11    22    23     1    24 
    2     1    21    24     4     3    18    22    15     9    17     2    14    22     4    10    15     1    10     2 
   22     5     5     8     5    22    16     8    18    16    24     6    12    17    24    14    11     5    14    16 
    5     0     9    21    15    10     3    15     5    17    18     1     7    23    18    24    21    25    13    22 
    3     1    18    23    24     2    20    22    13    21    21    15    16     5     0     7     9    20    20     4 
    9    23    19    13    15    10    17     7    11    16     7    19     1    24    16    25    11     2     1    19 
   15     1     5    24    11     2    17    17    18    19     2    17     0    13    11    18     0    12    18    19 
    2     8     9     8     4     0    10    18     9    19    18    20    11     1    12    20    19    15     2    25 
    8     8    21    22     3    25     7    19    17     5    18     6    18     0     4    18    13    15     5    16 
    7    25    14    21    22    21     0     7    22     3     8     4    14     0     0    24     9     6    12    18 
   21    24    13    23    17    12    12    10    20    15    12    14    21    17    25    18    15     5    13    22 
   13    21    23    18     3    22    17    14     3    12     2    16     5    11    12    10    11     9     7     1 
   15     8    10    16    15     5     6    18    24     4    18    10     7    20     4    22    12     7     3    12 
    4     7     6    12     9    11     6    14     1    14    22    10    10    10    13    25    14     6    18     1 
   16     7    16    17    10     4    12    19     3    25    16     5    24     3     3    20    16     1    23    17 
   20     7    15    19     6     6    13     3    10    20    20     7    15    15    24    24    12    14     6     1 


    9    18    24     0     7    19    19    16    12    14    17     3    20    18    25    22     0    13    10    11 
   25    16    11    18     1     3    15    16     3     7     7    12    15     8    20     4     5    17     2    22 
   22    18    12    22    20    19    21    21    13    13    16    20    22    20     4    16    12    20    13     1 
   16     1    24     9     2     4    23    24    10    18    19    12    15     7     3     4    11    25     1     5 
    9    15     7     2     3    16    23    16     1     1    13     2    11     5    13    24    14    22    17    11 
   24    20    12    15    18     0     6     6    23     6    25    25    11    20     1    15    12     5     8     0 
   19     7    18    11     7     7    19     6     8    21     0    23    11    22     7    14    25    11    20    24 
   25    25    24     9    20     7     1    14    21    16    11     1    16     9     8     5    25     5     4     6 
    4    20    23     8    22    18    16    19    24     9    13     5    23    16     9    19    19     7     3     5 
    9    22     9     2     2    11    15    18     4     9    21    12    11     6     0     0    11     2     1    12 
   23    24     9     1     0    20    21    18     0    14     3    19     4     3     0    14    24    23    23     9 
   15     3    10    15     4    13    19    12    22    22     5     0     1    19     5     8     4    19     6     3 
   22     2    12     9    13     5    11    15     7     0    15     8     7    11    21     8     6    14     5    14 
   11     0    15    13     2    19    17    10     0    24    21    14    21     6    13    21     8     7     7    19 
   23    21    10    25    17     0    17     5     2    23    16    14    20    19     4     8    11     0    13    22 
    6    14    22    15     2    21    13    25     6     8     4     3     3     9    19    23    15    18    11    21 
   13     0    16    15     8     0     3    22    14    22    23     6    13    20    11     8    16     3     4     9 
   12    21    12    10    18     1    15    12     7    18     9    22    10     6    24    20     7    22    25     3 
    8    23    21    18     6    15    24     9     6    14     3    20    20    23    19    19    19    16    10    11 
   25     5    18    14     1     0    13    25     7     4    25    24     8    16    13     4    14    12    11     1 


   13     6    21    14    17    24     9     2    11     5    25    22    10    24     6     2     7    15     5    23 
   20    11    11    17    24    25    10    14     0    22    10     4    10    13    13    12     2    21     2     9 
   25     5    11    17     2     0    10    23     5    13     3    18    23    21    19    16     9    25    12    20 
    5     4    13     2    19     3    13     8    22    22    19    12     9    14    25     7     8    18    25    18 
   18    15    18    20     1     6    16    24    17     3    17     5    19    12     4    11    25     4    25     6 
    8    15     5    25    20    10     2    23    22    19     0    18    16     4     2    17    17    23     8    18 
   10     8     2    13     5     2     5    24    17     4     5    25    15    19    10    17     9    17     6     0 
   23    15    17    20    14     6    21    23     6    17    21     9     4     2    16     2    18    18    16    11 
   20    14     1     3    24    25    18    17    25    15    22     7    23    15    14    24    10    25    22     7 
   24    16     2     4     8     5    25    14    10    19    25     3     9    23    13    16     3     7    16    11 
   25    13    16     1     9     6     9     6    13    14    20     0     2    14     6    22    23     9     5    24 
   19    16     2     0    10    10    10     9    18    24    14    25    25    18    17    13     6    25    22     0 
    0     4    15    20     8    22    12    15     2     9     5    18    21     0    11     7    16    16     0    20 
   11    25     1     3    20    15    14    15    13     3     8    17     5    21    22    21     2    25    21    20 
   20    13     4    14     2    16    13    24    13    19     9     7     4     7     5    24     6     5    13    11 
   16     8    13    17     3    11    21    16    19    25    18    19    17     9     7    24     2    16    23    12 
    1     8     0     3     8    19     1     3     4    20    20     1    22    12    10    21     3    12    21     1 
   25    10     0    20     7     0    10     2    12     2    20    14    10    21    10    13     8    17     0    13 
    3    21    21    14    15    24     0    16    25    25    10     9    24    15     8    17    18    23    11     7 
   25    23    16    14     0     6    24    25     1     9    24     6     4     5     5    11     6    15     2    18 


   20    22     7     8    21     9    16    21    10    24    21     6     1    16    15    12    18    17    19    14 
   20     1    13     3    14    21     1     0    17     4    17     9    21    15    15    19    13     2    13    19 
    4    25    17     4    24    15    14    12    18    25     6    17     5    18    14    17    21    22     3    12 
   23    13    16     7     4     8    15    14    13     0     0    22    10    18     3    20    12     3     1    24 
    0    13    23    20    10    23     8    25     0     0    20    15     2     3    22     9     9    22    23    19 
   24    10    23     2     8     8    19    16     7     5    14    14    10    15    18    12    11    13    11     6 
   20     1    16     7    16    13     0    17     5    10    19     5     3    24    11    18    10    18    21     5 
   16    22    19    21    17     1    25    11    17     0     9     6    13     7    22    13    11     4     2     1 
   18     2    17    25    21     4    13     3    14    22     2    19     1    16     3     4    14    12    25     9 
   21    19     7    17    14     0    21    22    15    23    17     5    22    23    23     0    20    12    24    21 
    9    11    15     9    19    24     3    12    13    16     3    14    16    15     3     4     5     6     9    22 
   21    15     4    13    10    11    18    14    13     5     2     3    17    14     7    11     6    25    10    15 
    2    14     9    24    10    18     0    23     0     1    25     3    25    17     3     0    24    19    14     5 
    9     6    24     5    20    14    11    14     9    13    24     7    23    23     5    18    12     3    15    25 
    2    18    20    25    22    17    20    19    14     6    15     8     8     4    24    16     9    15     7    23 
   16     3     4     5     2    25    24    23    17    10    10    13    25     6     7    10    18    13    11    14 
    2     1     7    12    17    25     6     8    12    17     8     2    17    22    17     7    25    18    12     7 
   17     9    14     3    16    16    23    24     8     1     5     5    19    10    13     8     4    17    20    19 
   24     7    19    21    18    20     8    14    10    21    17    21    20    10    23    25    17     3     1    17 
    4    16     4    18     7    23     5     9     2    19    25     1    11    20    24    18    17     9     5    23 


