   15    22    15    23    25    11    19    19    21    20    15    14    11     3    12     7    20    17     4    12 
   12     3     6     2     5     1    20    24     7    17    24    15    17    17    23    25    10     7    16     9 
    9     6    16     6    17    20    12    25     9     4    21     0    21    13     5     9     7    23    12     8 
    2     8    21     6    22    22     8    11     5    19    18    14     5    18    15     9    15    17    11    10 
    7    11    10    15    13    10     0    10    22     7     3    24    17     1    20    19    10     6    24    19 
   13    19    22    12     2     8    16     2     0    18    17    23    25    12    15    23    25    17     2    19 
   23     1    21    21     2     0     5     2    25    22    25     8    23    10     4    10    19     3     2    17 
   23     4    19    19    11    20     6     0    20    21     3     5     7    25    17    22     5     9    20    21 
   24    19     8     1    14     9     6    12     5     1    22    25    22    16    19     5     6    20     5    16 
    4     5     8     7    23    23     8    19    21    19     6     5    19    24    24    12    14    19     1    15 
    6     8    16    13    18     9    17    11     0    18    24     3    15     8     2     7     0    13    12    17 
   12    10    21    24     8     9     9     9    22    21     2     5    20     1     8    21     8    10     1    12 
    2    13     5     7     9    20    16    11    10    19     4    12    23    25    11    11    18    10    25    20 
    6     9    12     9    18     9    13    23    10     5     3     2    21    24    23     7     4     7    23     8 
    6     0     8    11     8    13    21    17    20     9     0    11     5     7     5    21     2     3     2    23 
   21    12    19    21    20     9    16     1    23    10    23    13    10     7    20     9     5     9    23     0 
    6    18    12    14     5    24    13     4     0     8     5    20     1     4    19     7    12     6     6     2 
   18    17    19    14    18    21    13    14     2    12     0     5    10     1    13     0     9    20    15     8 
   24    22    13    21     3    23     2    15     6    25    17     8    23     1    18     2    22     5     2     1 
   18    11     2     6    23    25    16     3     9     0     2    12    10    14     1     4     8     5     5    11 


    1    17    18     0     3    23     2    19    24     8    14    10     5     9     8    14    20     2    22     0 
    4    15    17     4    13    17    12    10    10    13    10    17    17    18    25     7    12    10     3    22 
    2    22    21    17    17    15     7    19    24    14    20     7    18     2    15    16    18    17    19    17 
   21    24    16     6    24    17     0     2    24    21     3    24    25    18    19     9     8     8     0     6 
    8    10    11    12     3     7     7    24    15     3    15    15    23    19     3     5    20     2    24     2 
   20    25    19     8    20    24    24    23    15    12    17     4     9    18    13    12    16    18     8    16 
    3    15    21    22     6     2     3    10    17    21     6     9    25     2     3     9    23     5     8     8 
   19     4     7    24    20    24    17    25     6     9     5    13     1     2    23     4    17    23     9    19 
   23    10    10     7    11    17    12     0    17    12    16    16     0     8     6    10    18    24    21    19 
   24    13    18    23    19    25     6    13    16     4     1    10    25    23    24    18    16    24    15     8 
    7    11    17    11    18    15     3    10     9    21    20    22     1     8    20     6    20    10    14    18 
   12     2     7    23     0    21    13    13    14     9     8     7     9     9     7     4    23    21    12    10 
   21    23     0     1     4    14    16     9     1    15    18    21     0    20    22    13    19     4    21    11 
   18    24     8     4    19    16     7    23    17    15    19    22    10     4     9     9    12    24    10    25 
   23     4    22     4    11    11    25    12    13    10     1     8    22    16    16    18    17    16     1    15 
    8    14    23    13     8     0    11    21    10    16     3    11    25    22    21     3    15    23     6     7 
    2    16     7    22    19    19    17    25    25    19    16    22    11    11    18     0     9     4    13     4 
   15    12    24    10    19    13    25    16    11     5    12    10    16     5     9    18    21    24    22     7 
    4    20     3     7    23    13    25    13    19    24    21    15    22    18     1     9    24    12    24    10 
   12    14    15     0     1    13     4    15     8     2     7    11    19    13     9     4    23    16     4     8 


    1    10     5    21    15    12    22    15    21     8    22     5    14     0    14     4     8     5     2    13 
   13    23     1    10    23    25    16    10    16    12    13    24    23     3     5    12    20     0    19    13 
    8     6     6    11     1    12     5    24     9     7    10    17     2    22    15     5     3    11    20    24 
   23     6    20    10    19    23     3     0    20    16     7    19     8     4     7    21    13     8    18    23 
   23    15    23    19    19    17     4     1    10     4    20    18    11    12     7    19    25    14    17     8 
   18    10    17    15    18    18     8    15    14    11     9    21     5    13    15    25    21    24    19     9 
   24     1     9    16    10    10    23     6     1    12    14    14    12    19     9    21     6    12     2     8 
   15     8    20     7    10     9     3    13     2    23    12    19    20    24    10    17    16    14    22    21 
    6    16    14    16    19    21    19    16     6    23    24    22    24     3     2     3     2    25     7    23 
    5    18     9    16    21    20    12     7     1    18    25     6    15    16     9    16    14    24    19     7 
   16    22    10     0     4    13     9     9    15     8     2     8    21    17    24    15    13    16    19    21 
    5     0    24     6    16    11    17     1    10    21    21     7    11    23    19    10    25    11    21     5 
    8    13    25     3    20    11     1    12    19    22    19     4    22     9    10    23    21     0     9     0 
   11     9     2     9     8     7     2    23    19    15    18    22    20    10    25    18     3    12     0    18 
   12    17     9    12    22    11     6    24     5     3    12    22     6    22    18     2     5     0    11    24 
   25    10    14    12    19    16    17    13    20    10    19    17    16    14     1     6    22    14    25    17 
   21     4     9     3    25    17    19    11    21     1    19    11     9     7     6     1     5    14     4     4 
    0     2    18     3    25     6     2     0    25    10     3    19    11     7    22    18     7     5    19    17 
    1    11     3    17     0     6     4    15     7     2     1     6    19    20    22    25    18     8    12     5 
   15     0    18     4    11    24    16     1    24    17    12    18     0    17    19    11    23     7     3    17 


   12    19    23     5     8     1    25    17    22     2     4    12    13    11    22    24     9     2    24    21 
   22     1    11    12    18     8    22     4     1     8    11     8     0    19    23    23     4    22    11    10 
   13     7     4     8     0    14    18     0     4     0    13     7     0    17    10    13    13     3    13     0 
    7    12    25    12    10     4     0    16     1    11    20    25    14    24    14    21    19    14    25    10 
   20    24    16    15     7    13    25    17     7     3    25     2    13    20     8    24    25     4    21    24 
   13    19     1     8    25    20     1     2    22     4     4    21     7    15    22    12     6     3    17    24 
   25     8    10    14    13     4     3    23    18    14     7    11     7    18    15    16     5    11    13    21 
   23     0    11    22    12     3     6     1     8     3    21    24    10    20    20    17    10    11    13    22 
   15     1    18    17    19     8     4    24    24    21     7    21    17    15     1     1     3     2    19    11 
    2    23    22    23     6     1    23    25    15     6    14     9    13     7    15     5     6     4    13     7 
    6    19     7     7    18    25     4    23    22    18    23    12    25    15    17     6     3    16    19    19 
   22    15    25    13    11    17    22     4    10     6    12     0    13    12    10    10    21    12    13     6 
   13    18    13     0    25     1    19     2    10    10     1     1    14    17    13    10     4     5     0     6 
   18    18    25    10    20    23    13    24    25     4    15    23     7    20    11    16    18    25    17    12 
    2     6     3    17    19     0    18    11    17    15    18    15    21     9     2    10    15     0     5    18 
   25    20     9    25    19     6    13    23    15     9     3    13    15     9    25     7    19     6    18    16 
   15    20     0    18     4    25    18    12     3    14     9     3     9    24    23    25    12    18     8     1 
    6    25    10    17    19     6     1     6     7     5    25     7    25    19    19    13     7    20     6     2 
   11    23    24     3     5    10     2     9    11     5     4    25    15     6     3    14    25    23     7     8 
    7    23    19     8    12    21    25    24     0     5    20    13     8     2     3    24     7    23    21     6 


   25     7     5    15     4    18     7    19    17     9    12    17     4    18     4    21    15    20     5    13 
   23     3    24     4     2     0     4    22     6    10     5    18    19    20    19     1    19    18     6    14 
   10    21     0    17    18    25     9    21    16    13    24    15    10     9    18     4     3    20    21    25 
   13    22     2    20    11     7    24    12     5     6    25    13     0    11    15    11     9     2    21    18 
   17     0    12    23    14     0    25    23    25    12     9     5     5    18    21     0     1    24    21     1 
   11    15    22     3     4    14    11    21    13    14     9     7     6    13    20    13    17    17     2     2 
   10     4     2    10    24    23    19    10    19    21    12    18    17    25    21     0    18    12    18    22 
    2     1     1    23    18    23     6    14    14    17     0     3     8    16    11     4     8    18     7    11 
    0     6    16     0    21     9     7    23     7     6    21    22    10     7     2     5    20    17     0     9 
   24    21    18    14    18    21     4    11    20    15     8     1     4     2    21     6    25    25    15     2 
    6    15    24     5    16    12    14     0    17     0     7    23     4    19    22    25    10    19    24    20 
    7    21    23    13    18    21     2    21     3     7    18    12     2     1    13    17    19    19     5    17 
   18    15    14     6    16    11     0    10     6     9    17     6    23    23     9     6    11     1    20    12 
   16    23    11    10    13    13     9    22    17    24     4    22     4     1    23     8     1     6    10     8 
    0    14    25    23    20    19     7     8     4    13    13    15    18    16    11    23     0     4    16     9 
    7     5    18     9    20     3     2     1     2    24    17    17    16    21    18    21     6    19    24    20 
   14     2     6    22    22     2    14     8     4     9     6    14     0    13    23     8     9    14     3    16 
    2    13     8     0    14     0     1     4    11    14    15     5    13    13     7    23    10     6     7     1 
   24     5     0     9     8    19     0    19    18    23    24     5    16     2    20    21    24     1     7     3 
   10    10    16    25    22    11    11     7     9     8     2     6    15     7     2    12    12    15     6     1 


   21    23    23    17     4     4    23     1    10    19    12    22    11     0    13     7    22     0     1     4 
    1    18    15    11     6     0     9     6    17    23     0    13     1    21     0     4     4    23    16     7 
    2     8    24    15     7    22     9    11    17     3    15     8    11     3     4    23     3    23    10     4 
   13    24    20    16    10    13     1    10    24    12    11    18     7    24     6     5     1    20     7    25 
    2    20    16    25     9    19    15    15     5    12    25    10     2    22    10    15    13    16    19    17 
    0    13    14    15    23     8    15     0     0    16    16    23     8    17     4    12     9     6     6    24 
    3     2     8     9    12    20    16    19    21    19    14    23    18    14    20     0    23    22     2    20 
   22     5    22     4    12    23     2     8    16     8    17    22    13    24     0    13     9    19    22    21 
   24     2    23    20     2     9    14    17     3    12     9    25    11     8     3     6    22     0     6     1 
    9     0    25    25     8    20     5     7    16    21    13     2    10    20    18     2    22     2    24    25 
    6    20    11    18    24    10    23    15     0     2    11     3    15    17    12    22    24    11    12     7 
    8     4     4    17     2    24    15    19    16    15    20     7     4    11    13    24     0    23    19    20 
   15     3     8     3    19     8     9    20    20    24    23     4    19    13     9     8    18    15     6    20 
    2    20    10     8     3     9    22     0    19    24    16    10    15    11     4     2    21    15    18    14 
    4     1    21    14     2    12    17    25    21    21    18     8     1    10    14    10     2     5    11    16 
   20     8    10     5     1    12    17    25    15    19    25     1     1     0     5    23    11     8     9    22 
   20     0    14     6     5    13     2    10     4    25     3     3     6    20    20     8    13     8     0    20 
    0    18    13     6    25    13    20    24     9    17     8     7     5    21     2    19    14     5     7     7 
    2     5    10     0    20     5    24     4     7    17    11     9    24    22    12    22    15    10     3    19 
   18    10     0     4    12     6     9    18     5    22    22    21     1    23     3    17    19     3     9     7 


   10    12    16     9    11    22     6    12    10    22     5    21    21     0     9     8     9    25    24    22 
   24    16     8    22     7     4    13     6     6    14     7     5    15     3     4     4    20    11    19    11 
    8    13    20    20     7     2    12    10     1    12    10     5     2    11     7     4    17    13    13    14 
   16     0    23     1    24     9    16    15    14    24    10    16     1     7    12    12    21     0     4     1 
   20    12    14    18    13    10     5    11    23     8     6     6    15    18     0     8    14    18    25    16 
   19    19     4     6     3    14    18    10    16    25    13    15    11    12    14    17    20     4     8     9 
    3    21     5    12    20    25    14     1    10     0    22     0    11     0     4    14     0     1     1    13 
   23    15    23     8     0    12     7    12    19     0    16    21     5     4    14    19     6     8    11     8 
    4    13     7    15    13     9     0     9     7    13    24    18    21    25    16    12     8     0    15    19 
   25     2    14    11    10     1    10    24     4    22     6    18    19    24    20    20    19    11     3     9 
    0    16     3    15    13     5     8    24     3     9     9    19     0    14    25    12     9     6    25    24 
   16    21    21     1    11     9    20    21    13     7     9    12    13    15    14    15    17     6    10     6 
    0    24    14    16    20     8     9    15    18     9     9    12    10     9    15    16    13    10    20    23 
    4     3     8    15     0    25    24    22    25    25     0    18     4    12     8     1    18    16    16    17 
    6    21    21     2    11     7    16    13     0     1    17    15    25    22    14    24     7     6    17     1 
    9    18    19     7    12     9    19    21     7    21    25    13     2     6    15    10     6     7    21     8 
   19    23    14    18     5     7    23    12    17    24     1     9    22     8    10     6    16    22    25    14 
    6    19     5     0    25    12     7    10    12    17    14    16     8    20    14     2     1    19     3     3 
    5    11    18    15    12     1    10     5    13     8    22    14    18    11    13    10    22     2     6    24 
    4     2    23     1    10    15     9     9     3    16    20     8    24    13    19    24     3    15    22    18 


   15    22     1     8     4    18    24     5     5     5    15     8    10     4    21    15     7    17    23     5 
   17     4    10     9    14    19    24    12     3     1    12    24     5    12    13     7    24     0     8     8 
    0     5     5     2    13     5     4     8    21     9     9     2    23    22    14     6    15    17    17    21 
    6    11     4     3    11    24    10    14     3     7    22     5     9     0    18    10     5    25     5    11 
    5     9    24    13    12    12     8     1    25    17     9    22    20    18     2    21     5    23    13     2 
    7    18    20     9    25     6     2    23     8    23    13     5    21    24    12    13    14     5    14     0 
    3     1    19    22    23     6    17    19    12     7    18    23    19     8    14    22    23     8    25     2 
   18    22    13     2     2    15    10    16     0     7    22    21    19     3     8     7     5     3    19    22 
   21     2    12     0    21    16    14     1     4    20     9    25     1     5    21     8    10    15     9     6 
   17     0    11    12    22     9     0     3    20     5     9    22     1    12     2    19     1     5     6    19 
    7    15    25     8     0    24    25    15    10     4     8    15     4     2    21     5     1     6     3    14 
   23    20    15    15    13     7    20    16    17    13    18    24    17    24    12    12    11    16    24    10 
   25     4    13     1    20     8    10     1     9    12     5    13    24     8    24    14    22    21    23    10 
   23    25     5    25    16    20    25    21     6    15     3     8     5     5     3     6     5    10     1    15 
    4    15    15     4     0     9    20    18     1    11     4    15    14    14    25     5    16    13    18     3 
    6    16    16    22    13    13    15    18     9    16    12    10     0     5     0    10    21     7    10    23 
   19    20     6     2    23    17    17    24     5     1     7    13     7     4    14    14    10     2    12     9 
   15    25    18     6    23    24    15    15     8    22    11    14     6    19     7     8    18     6    17    24 
   23    19    18    24    10    17    13    12     3     0     3    15    18    13    12     6    22    25     0    10 
    2    12    16    16     1     3    18    15     4    22     5     6    17    22    21    14     8    24    18     9 


