    1     9     8    11     4    11    22    15     5    11    21    25     2    10    20     7     9    18     7 
    3    11    17    16    20     4    11     6    21    16    17    13    17    15    22     2    13    21    20 
   20    17    24    22     7     5    23    22    23    19    21    23    22    22    20    10     6     0     8 
   12    22    20    12    11     8    14    20     2    16    14    22    15     1    24     4     3    17    13 
   19     3     1     9    18     7    12    22     7    25    15     6    13     9    24    17    24     9     8 
    2    22    13     4     9    13     1     9     2    17     0     4    16    11     1     9    12    11    23 
   11    21    15     8     0    16     9     1     3    19    23    12    17     6     9    20    20    24    15 
   19    25    13    14    21    23    18    11    13    20     9     0     2     3     4    14    13     9    16 
   11    14     0    17     7    23     0    25    16    20    12     6     3    17     4    16    22    17    14 
    4     4     7    13     9    11     6    18    12    20     1    18    17    12    24     0     5     9    19 
   18    15    25     5     7    11    10    19    21    25     1     4     4    20    25    18    20    13    22 
    9     5    16    18     6    12     8     4    24    14     2    24    12     6    18    24    23     6    10 
   12     6    17    12    12    15    10     1    13    18    13    19     3    19     0     4    20     5     5 
    6     0     1     5     2    13     0     3     6     6    12    15     8    24    20    16     9     2    12 
   12    19    23    12    24     4    13    14     5     3    23     0    10    18    17    13    16    16    16 
   21    16    16    19     1     2     9     6     9    10     8    22     7    19     4     2     6    18    21 
   20     8    20    23    15     1     6    23     8     5    10    22     3    23     7     2    17     2    16 
    7     6    15    14    12     9    14    25     7    21    24    10    25     8    24    24    15    19    11 
   25     0    22    21    17    20    18    12    15    21     8    19    25     7    21    13    20     0     0 


   10    12     0     8     4     0     9     2    17    18    13    21    24     7    17     8    12     1     6 
    3     5    13     0    25    19     0     8    22    13     2    12    23    19    13    22     8     8    10 
   25    16     5    16    16     1     8    22    20     6    20    21     1     2     4     8    16     1     6 
    3     2     7     0    11    14    15    20    10     0    23     3    16    14    24     6    24     3    13 
   14    22    18    18    16    16     6    20    22     5     5    17     1    12     8     9    24    15     0 
    6    20    18    17     2     6    14    11    15     4    17    20    24    20     4     7    10     6    16 
    7    24     6     9     9    24     6    11    20    10     9    22    12    10    21    24    20    11    25 
   19    23     1    18     7     4     1     7    22    18    11    20    18    22    10     4     0     6    11 
    2    21     8     2     2    23     0     3    23    20    11    25     5    14     9    17     4    13    25 
    4    14    18    12    21    21    12    17    20     5    19    13    18     0    16    21     0     0    16 
    7    14    24    14     1    12    22     5    10    14     4    14     3    23    14    22     0     4     5 
   16     6    24     7    22    13     0     3     7    13    12    18    24    25    18    20    18     8    10 
    4    11     4     2    22    25     3    18    15    14     6    23     2    12    25     4     8     0    18 
    0    25     5    16    25    23    13    14    18    22     6    12    17     4     8    18     1    13    12 
   22    14    24    14     8     5     0     0    24    11    15    24    22    20     8    21     0     0     0 
    7    12     8    22    15     1    16     6     3    14    18    18     7     9    12    12    16    10     9 
    1    18     2    11     0    18    23    15    19     8    23    14     4    19    19    12    20    25    24 
   18     1     5     3     9    10     0     8    13     1    23    13    16     1    22     8     2     2     4 
   22    10    17    16    11    21    17     2     6    20     7    16    12    22     8    25    22    10    12 


    9    10    22     4    16    10    20    15     9    14    10    22     5    13    16    23     1    11    16 
    2    16     7     5    10     1     3     0    24    24    18    16     2     7     2    13    13     7     8 
   25    22    25    12    14    16    17     6    20    22    17     6     7     0    25     7    23    18    18 
   19    16    18    19    11    19    17    19    11    13    11    15     3    25    17    10    14    15    18 
   25    17    25    11    12     1    12    11     7     8    13     7    18     6    14    23    25     4    15 
   14     9     1    16    18     7    23    24    12    16     0     9     7     0    15     0    11    12     3 
   11    12     0    11     4    10     0    24    23    17    19    20     5    23    11    14     7    21    15 
   16    10    13     2     3    14    17     4    18    21    21    14    16     6    23    24    11     4    11 
   23     9    23    25    11    18    14    18     8     8     4    13    13     7     3     4    15     8    21 
   17    23    19     5     4    25     5    19    24    17     9    11     3     2     6    20    20    11     7 
   21    12     6     2    13     4     0     9    17     5    13    20     8     2     5    19    13     2    15 
   15     8    21    18    17     5    20    18     8     4    24     5     1    24    17     6    25     0    18 
    6     5    21    16     8    18     3     2    16    20     2     2    21    14    18     5    12     5    13 
    5     1    18     7    10    22     3    20    19     9     6    15     4    25    20    21    10    22    19 
   21     0     6    21     8    23    10    23     4    24     8     5    19     7    19     7    23     3    22 
   14     1     8    21     3    23    10    20     6     2    23     0     0    15     3     2     0     6    10 
    2    11    16    19    17     9     3    14    11     5     2    24    24    21     3    18    21     3     0 
   10     0     5    21    16    10    14    20    22    17    23    10    14    12    16     3     9    20     8 
    8    10    17    13    24    18     6     5     4    11    15     8     6    10    23    21     5    20     9 


   13    14    10    17     4    19    17    11     1    19     1    15     0     0    14     8    14     9     0 
   18    14     9    18    18     7    25     7    22     3    22     3    25    25     4    21    15     1    20 
   17    19     4    24    14    10     6     3    18    19    19    11     3    24    21     4    20    15    17 
   12     1    18    21    22     5     3    16    19     8    18    15    22    17    15    21     5    12     0 
   10    17    17    17     9    22     3    15    12     4     1    15    17    25     4    20     0    10     5 
   10    13     0     7    11    22    13    12    25    19    25    19    21    10    17    12    16    16    18 
   25     8    18    19    18     3     0    20    11    20     6    10    22     8    19     4    25    16    15 
   24    20     4    25    18     6    23     9     4     9     3     9     9    22     5     0    11     1    10 
   10     4     9    20     9    21    18    24    21    12     5     1     5     1     6    19    13    11     9 
    2    19    25    13    16    25    13    24    20     9     6     4    14    13     9    12     2    14    19 
    1    22    12     9    18    19    17    12    14    22    23    24    20    14    10     2     6    15     4 
   16    22     3     7    23    13     9     1     0    12     0    17    21     6     5    21    22    25    18 
   22     5     2    21     2    16    15    12    10     6     2    15     9     9    13     7     8    11    10 
    4    23    22     6    14    10    25     2    14    16    18     1    13    16     3    13     0     0    25 
    1     6    17    21    19    20    21    21     4    11     7    25     6    18    16     3     5     0     9 
    8     5    24     8    18    16    14    20     8    18    19    25     0    14    12    15    22    17     3 
   16     0    14     2    12     6    21    12     4     4    22     1    20    17     0     1     6     6    18 
   23     1    17    16     2     2     2    10    20    20    19    12    15    21     7    21     1    17    14 
    5    23     7    22     9     7    15     5     7    23    12    13    13    12    19    17    20    10    12 


   19     3     6    18    18    20    19     0    25    21     3    18     1     4    19    16    18     3    15 
    8    23    16     1    10    10     4    12     7     6    12     4     4    17     0     2     5    23     6 
   13    12     6    16    14     7     5     6     6    20    24    24     8    24    21    18    16    23     7 
   15    11    11    15     5    14     8    24     9    22     9    17    13    11    22    16    19    20     2 
   11    22     2     5     6    24    23     5     4    19    10    25    25     4    12    25     9    12    13 
   23     9    18    20     2    20     9    25    15    12    17     8    14    11     7    13     1    15    18 
    1     0     0    15     1     4    14    11     8     9    25     7     5    22     7    15    20    22     0 
    3     6    17     7     9    16    25     6    24    25     2    19    10     2     8    20     0    14     6 
    7    24    18     2    19    15    15    22    23    20     8     1    10    20    17    17    16     5     9 
    6     2    25    22    11    23     4    18    19    16    16     4     7    15    22    23     8    13    24 
   22     9    17    21    20     0     7    10    16    16    11     5    13     2     0    25    20    22    10 
   14    16    15    10     5    25    10     3    17     3    18    14    21    23    10    17    23    15    16 
   14     0     5     9    22    15    11     5    17    17    16     7     7    25     8    22    21    19     5 
   20    21    23    12     0     8    17     2    11    19    17    25     2     5     9    11    15    14    23 
   19     4    20    11     2    16    20     3     5     4    21    13    23     4    10    14    11    15     6 
    4    22     7     0     2     6     6    11    20    17     8     5    11    19    22    12     9    16    13 
   21    12    10    17    19    13     3     1     3    16     0    25     1     5    10    18     0     3     8 
   22     7     9    15    14    12    17     2    17    18    19    16    18    12     2    22    22    15    24 
   16     6     8    24    23     1    25     7    15     7    14     8    21     6    18     8    21    20     7 


   18    11    21    23    20    24     7    24     3    24    16     8    17    11    17    21    20    16     6 
   10     9    15     9    19    24    15    20     3     8    18    12    19    19     8    22     9    13    17 
    6     5    24    19    17    14    13     8     1    17     2     3    14    13    19     8    10     8     1 
   19    25    17    19     3    10    23    25    23    20    19    22    20    22    18    24    19    16    22 
    9     4     0    20     6    12     2    17    21    13     1    25     5    23    13    13    16    16    11 
   25    15    18    23     4    25    20     1    18    10    13    19    12    12     6     6    16    25    25 
   12    13     7     9    18    22     2    11    23    16    22    11     8     2     1    25     3     6     2 
   20     5     0    15     8    25    17    10     7    16    21    20     2    23     0     0    22     1     5 
    6    17     3    19    19    15     4    19    15    22    17    25     8     0     1     3     8    16     2 
   20    17     8    20     3    19    17     9     6    21    22    12    18    15     0    20    22    21     3 
   18     5    20    25     2    22    16     3    24     7    25     6    16    19    23     6    25    24    22 
   18    22    24    22     3    23    11     1    19    18    23    23    19    24     8     7    21     0    15 
   12    20     1    19     0    25     8     8    19    22    22    25     7     7     2    25    25    13     7 
   22    12    23     1    18    16    10    13    11    21    17    21     2     1    25    13    11     1     0 
   22     3    18     8     5     2     0    11    16    23    14     9    24    22    20    11     9     5    11 
   25    24     4     6    10     3    22     3     9     6    23    14    14    14     1    22    10    18     1 
    0    15    16    11    18     6     6    23    22     6    24    13    22    25    21    19    18     7    11 
    5     9    22     1    24     3    24    11     2    15    16    14    24    12    24     4     6     3     5 
    2    19    13    16     5    12     2    15    17    23    20    19     4    21    20     6    22    18    21 


   15    14    24    22    14    17    21     8    12     5    17    14    25     0     8    13    24     3    10 
   22    16    23     2    12     2     4    24     3     2    25    23    17    18    24    17    18    14    19 
   22    23    14     0     1    17    13     8    12    10    21     6    11     6    11     7     3     2     4 
    4     8     7    12     2     9     1     5    25    25    24    24     9    16    24    20     9    15    25 
    1     6    15     0     7    12    23     5     6    17     5    25    11    12     0    23     0    21    16 
   24    21    15     5    14    17    16     1    12    14    11    14    12    19     1    17     9    18    13 
   25     4     8     4    10     6     4     6     9    14     4     6    19     6    10    24    18     9    23 
    6    24    16     2     0    23    22    24    20    11     2    20    19     1    25    23     3    19    16 
   21    17    25    20    11    23    21    20     1     7     9    21    18     5     7     8     6    18    15 
   16    12    12     3    17    22     0    16     9    24    12     2     1     8     6     5    13    25    20 
   16    22    17    11     8    15     1     1    10    24    15    25     4    24    20    11    21    22    19 
   15    24    13    18    12     5    19     6    13     6     7     2     9     6    23     2     6    25     1 
   21    22    24    24     0    10    21     5    16    12     2     6    23     2     0     9    19     0    20 
    6    18    10    11    17     1    13    25    18     0    22    16    14    19     3    15    21     3    13 
   24    19     1     7    10    24     3    15    22     8    15    10     2    21    22    15     7    24    10 
   25    10    13     8     0    22    20     2     3    24     2    13     8    21     1    25     3    25    13 
    0     3     5    22     4     5    12    17     6    10     4    14    25     4     7    24    22    15    12 
   18    22    24     1    13     3     5     0    12    23    13     2     6     8    15    15    22     1    18 
   11     5     3     6    19    13    24    11    12     0    12    22    11     1    10    10    25     7    20 


   19     9    12    11    25    11     3     9    14    20     8    10    23     0    10     9     7    14    21 
   13    14    11    25    21    11    12     3     5     1     1     9     1    22    17    18    22     1    18 
    7    20    22    24    19    10     2    20     5     0     9     8    19     2    23     2     4     4     1 
    2    24    25     2    23    21     9    20     8    21     7    20     1    22    23     1    10     1     0 
   20    25    25     1     3    17    22     1    15    16    17    25     0    14    16    21     5     9     0 
    6     5    19     5    22    25    20    19     0    18    16    13    15    23     7    20    10     1     7 
    4    20     0    25     6     5     8    19     9     2    22    23     3    23     3     3    15    14     4 
    2    17    14    11     4     6     1    18    12    12    10    22     5     8    16    16    10    14     0 
    1    25    10     4     5    22     0    18    17    10     3    10    13    14    18     1    19     0     5 
    7    13     9    13    14    22    14    11     9     4    12     6    12     1    22     3    23    16    13 
    6     5    21    18     5    25    16     1    11    14    14     5     0     0    23     9     6    24     5 
   15    22    11    25    18     1    12    16     9    10    12    23    22     5    17    12     9     0    13 
    8    20    14     6    16     7     3    12     6    16    23    19    20     7     7    13    15    19     5 
   22    10    18     8     4    25    14     7    12     2    16    16    20    19    14     5    17    11    17 
   16    11    24     3     9    12    25    12     4    12    22    16     4    18     9    13     1     8    16 
    2    24    19     1    13    12    15    16    19    24     6    18    11    15    22     1     0     2    24 
   19    16     8     4     5    22    15     9    10     1     6    24    17    21     3    15    11     4    20 
    8    13     4    10    21    25     7     8    11    12    24    14    16     9    25     9    25     3    23 
   23     8    10     6     2     0    16     9     5     2    22    20     7    21    10     1     0    12     8 


