    9    20     9    22    23    24    25    21    12    13    15    20    10    14     4     3     3    10     6    16 
   13    17     6    19    13     4    13     4    12    16    16     9    21    10    20     9     2    14     6     5 
    1     0    10    15    14    17     8    10    16    24     7    24     2    11    22    11    25    13    12    14 
   24     7    25    22    21    23     7    17    24    13    11    22    10     3    11     9     9    21    20    11 
    5    24     6     5    16     6     8    19     6    21     8     0     7    20    24    12     7    21     9    12 
   15     9    17     9    10    22     0     4    23    14    13    14    25     8     5    24     6     3    15     9 
   14    20    15     2     7     0    24    15    12     5     2     9    24    10    23    20     9    22     9    25 
    3    18    23     8     8    15    20     6     3     8    25    24    25     4    17     8     6     6    17    13 
   15    17     8     7    19     2     1     2     9     3     1    18    22    15    11     5     6     2    18    20 
   25     1     6    18     3    15     5    25    15    10    15     6     6    23     5    25     1    23     2     0 
   10    23    21    23    18     1    19     9    21    21     0    24    18    19    14    12     3    15     5    23 
   10     3     1     6     2    14    16     2    23    25     7    15    15    14    19    25    10    19    25    21 
   17     3     1     5    23    13     4     2    19    20     8     7    15    11    12    17     0    10    15    21 
   20     7    24     4     4    16    16    16    18    17     6    17     2     0    23     5     8    22     6     5 
   15     2     6    23    22    24    23     4    17    17    13    20    15    23     1     0    12    17     3    24 
   15     6     2    23    19    11    18    23    18    10    24    10    10     5    14    13    12     2     1     5 
   18     7    17    16    19    13     1    25     0    13    17     3    22    20    23     4    13     5     4    16 
   24    17     4     8    22    12     9    13     4    20    25    13    10    13    19    21     8     3     6    22 
    0    23     1    17     6     1    15    17    22     6     9    10     2    18     2    10    24    21    10    19 
   18    10    14     5    19     0    11     3    13    22    11    24    23    11    10     0    16    13    11    23 


   13    14    13    17    22    11     1    14    17     4     4     1     5    11     6     6    23    25    15    17 
   25    25    16     5     5    10    23    20     3    21    21     7    19    23    17     7    25     6    14     3 
   14    18     6     2     7    17    21    12    19     0    12    17    11    17    25     7    21    17     7    16 
   23    15    11     7     1     7     5    20     4    24    19    10    14    11    15     2    15    18    16     0 
    9     0     6     5    12     8     9    11    11     3    13    24    25    15    16    20    20     6     3    24 
   25     1    11    13    23     3     0     9     1    13    19    16     2     9    13    17     2     4    20    25 
    1    17     9    11     2     8    20     8    16    18    22    23    16     3     9    17    24    16     8    23 
   18    18     4    19     1    17    16    13     4    19     3    24    22    14    18    13    18    10     1     8 
    8    18    15    10    20    22    13    23    13     2    18    13    12     2    23    15     8    12    14    20 
   16     4    25    13    16     9    23    14     6    20    25     7    17    18     8    12    23    25     2    17 
   24     2     2     3    11     3     0    23     2    17     9    23    21    24     2    15     5     8     9    15 
    0     3     2    21    22    18    21    18     4     3     3     5    18    15    15     9    25    25    18    10 
   17    17    19     7    20    16     0    13     7    21    23    21    15     5     8    24    25    22    19     9 
   15     0     1    12    15     0     8    14     8     0    10    12    21    20     8    14     1    10    23    19 
   11    18     7     5    23     8    12    14     3     4    11     0    18     2    22     1    19    23     6    16 
   22    22    25    22     5    23     3    12     9    25     2    23    14    14    22    19    16     6    14    10 
   16     8    20    24    20     9    23    22     5    23    14    13    24     4     2     7    23     2    24     6 
   14    16    21    19     4    22     1    22     2     3     6    16     0    16    13     3     7     0     3    25 
   23    13    20     3    10    15    13     9     5    24    16    18    19    22     7     7     5    23    10    21 
    8    19    18     6     6    21     0    25    23    17    14     1     3    23    17    17     9    11     6    23 


   18     0    19    10    24     9     8    24    13     1     8    15     2    14    22    14     2     4     7    14 
   21    14    24     7    11    13    13    21     1     4    15    18    25     2     4    13     3     8     2     4 
    7    21     6    23     3    22    13    16    18    22    14    22     1     7    15     8     1    21     1    24 
   25    22     9     8     4    23    22    13     4     4    11    16     4     4    25    24    18    24    13     2 
    4    15    10    13     9     6    18    22    14    12     9    11     4    15    23     4    10     9    22    23 
    2    21    19    14    12    18     6     8     8     9     7     7     8    18    17    25    13    10    10     5 
   23    14     6    14    24    23    18    12     7     7    12     1    14    12     1    25    16    25    11     3 
   11    14    23    10    11    13    20    13     2    23    19    13    10    23    21    17    18    13    23    22 
   10    17     7     3     5    24     8    22     9    16    10    21    24    22    17    22     5    24    14    16 
   22    11     1    12    11    25    23    12    21    13    16     0    10    13    25    11    23     7    15     1 
    5    14    18    11    16    21    21    21    12     6     3     2    12    10     3    20    10     9     6    17 
   18     0    24    13     9    14     7    11     6    25    10    12     9     9    24    25     0    14    15    11 
   16    15    22    11    14    12    24     6     9    25    12    17    17    18     3    11     3    24    22     6 
    2    23    11    18    20     4    14    12     3    17    12    24    11    14    19     3    21     0     8     7 
   14     5     3    14     1     0    25    19    17    12    16    23     6    18    14    11    12    13     5    13 
   17     6     4     4    18    12     3    19    16    19     5    24    14    21    11    10    14     0    25    16 
   13    15    22    13     9    16     7    19    18    22    14     3     6    25    10    16     0     2    16     7 
   23     7    11    14     6    10    11    21    14     1    14    22     3     8    22     4    22    12     0    17 
    2    20     4    17    22    10    14     8     9    24    15    18    16     1    15     5    21    10     2    25 
    9    11     9    15     1    11    18     3    11    11    22     3    13    17    11    12    12    22    11    24 


   14     6     4    25     8    11     0    11    13     1    20     3     5    19    19     7    11    11    16     1 
   13    23    23     4     2    12    25     6    16    17     0     9     8    16     5     3    11    23    22    22 
    7    11     5    15    14    20    10    13    16    12    14     0    17    20    16    12    12     8    22     2 
    4     1     0    15     1    10    22     9    24     4     0     8     2     7    14     1    23    12    11    13 
   13     3    16    14    21    12     6    21    15     7    12    12    16    12    11    15     9     4    10    13 
   20     3     5     0    12     4    22    14    24    25     3    18    20     4    10    18     6    13    20    21 
   23     3    19    24    19    25    12    13     4    19    17    20    18     7     5    13    11    16    24    14 
   17     9    12    21     8     0     0     3     7     3    12     6     8    10    10    10    25    11    10    23 
   10    14    22     1    14     1    23     3    20    25     6    16    12     6    22    21    22    11     2     6 
   14     3    11    20    16    22    10    15     5     1     5    21     9     1    18    18     8    21     5    13 
    2    17    10    10    14    12    25     1    14    24    12    20    22    18    14    16    25    18    11    13 
    2     4     0     7     1     8    24    12    16     2    10    13    24     1    12     8     3    19    16    18 
    3    15    21    22    16     3    20    19     1    21    21     1     6    21     6    17     9    15    23    14 
    7     5    15    13    14    19    21     0     8    19     8     5    17     2    15     4     0    19    21     4 
   21    16     2    14    10    10    23     1     8    20    13     2     7     2    19     4     7     3     7    16 
    9    14    15    13    23    18    19     1    15    23     3    14    23    11    19     4     5    20    11     3 
    2    22     5     4    18     7    25     2     5     4     1    16     8     4    11    12    16    19    18    21 
   10     8    12    19    10    23    23     2    17    13    24     7    16    17     9    20    24    19     1     7 
   10    15    24     0    25    23    25    20     5    21     0    12     0     5    15    18    19     8     4     9 
    9    18    20    14    24    17    17     4    21    10     6     1    17    21     4    17     4    24    24     8 


    3    10    24     6    11    10    14    18    17     8     2    17    13     6    19    17     7     4     0    24 
   14     0    13     6    22    15     8    22    17     0     2     9    14     7    10     5    13    13     7    22 
    6     4    22     9     3    15    13     5     0    21    19    14    21    19     6    12    12    17     8     0 
   18    16    19    22    24    17     6    22     8    12    13    12    14    13     1     4    23     5    10    10 
   21     1     7    25     9    21    13     9     7     6    14    15     4    12     2    21    23    12    20     4 
   19     0    19    10    12    19    24     3     4    24    18     3     2    10     9    17     9     7    19     6 
   17    10    11    10    19     1     4    10     3    24     4    16     8    12     8    15     6    14     1    13 
   19    14     2     2     7    21    17    24    25    17     6     4    23     7    22    21    20     6     1    20 
    2    10    16     5    21    14    20     7    25    13    22    25     2    13    22    18    13    23    13    16 
   17    21    23    15    14    22    20    18    18     3    13     6     1     7    16    17    12     1     8     0 
    8    13     6    22     6     7     1    20    14    24    24    24    20     6    14     1     8    15    17    20 
   15    14    22    10    17    10     7    21    23     4     2    12     4    23     3    18    24    14    22    14 
   19    20    18     1    15     2    14    13     1     5     5     7    12    20    22    10     3    24    12     9 
    0    14    21     5    12     5    12     1    12    20    12    13     3    15    17    12    22    12     4    12 
    0     8     2    19    14     8    21     3     3    21     0    20     9    10     8     7     8    20    11     9 
    4    15     0     9     3    18     7    15    12    20    12    20    14    15    16    15    15    19     4     8 
   10    15     1     0    20    20    22    19    16     7    21     6     0     9    10    19     7     9    14     3 
   18     4    24     9     2    23    20    19     1     0    17    23    10     7    11     4    11     2     5     7 
   24    10    10    19    25    15    15    16     5    24    23    19     3    23    20    17    25    19    11    21 
   18     5     7    21    20    18     9    12    17    22     3    14    11    16    20     7    16     5    12     1 


   25    13    25     6    10     8    13    19    25    25    24    22     5     8    14    16     2    22     6     7 
   14    25     6    21    10     6    20    15    13    11     8    15    12     3    12    23    10    13     2    17 
    7    23    23     3    17    10    22    16    21    13    12     5    14    22    22     6    16     7    21    24 
    2    19    24    15     1    11    19     3     0    15    17    16    19     2    21     7     2     6    25    20 
   20     4    15    18    20    16    15    13     2    15    15     3     4    23     2    23     5    23     6    22 
   21    17    25    11    20     6     2    25     6     2     0    12    16     0     9    19    13     5     9    15 
   17    19    19    24    10    17    10     1    10     5    20     9    20    13     1     2    24    19    25    19 
    5    16    12    19    25    17    12     1     0     1    18     6     4    23     3    10     5     3    13    19 
    9    21    13    10     1     1    20    25     0    23     6    11     8     0    20     0    22    10    22     2 
   21    21     3     5     7    20    24    11    16    12    24     2     6     6     6    17    12    14    24    25 
   21    22    14    15    25    18     5     0     2    24     5     5    23    12     4    15    11     7    23    24 
    0    10    21    14    18    15    24     9     9     4    24    20     5    13     2    25     8    17    13     2 
   19     8     8    16    15    19     5     0    20    17    19     6     5     2     9    24    16    20    22     1 
   17    12     2    11     7    11     8    21    21    10    24     4     1    12    12     5    19    18    22     5 
   21    13    18     7    19     4     3     0    15     7    25    17     0     1    10    14     8    14    20    18 
    4    23     7     2    15    17     9    16     5    20    15     0     3     0    11    10    14     2    23    17 
    7    10    14     7     0     1     5    14    16    10     6     6    14    16     7    11     1    21    17     4 
   20    19     8    20    24    11    16    19    17     7     2    18     5    25    10    25    18     8    22     8 
    2     0     3     1    19    13     4     0    23     8    23    17     4    19    18    15     1     3     3    21 
   22     5     1    24     7     3     6     9    25    17     2     9    20     0     3     1    14    21     9    18 


   17    15    13    10     5     8    24     8     2    10    14    14     7    18    25     1    24    20    21    20 
    5    14     4    22     6    21    21    24    14    18    22    17     7    25     3     3     2     9     0    11 
   12    11    14     1    13     3    17    12     2     9    15    25    25     5    14    10    22    14     6     8 
   21    21    17    18     6     4     4     7    10     1    25     0    22    19     7    24    10    20     9    14 
   20     1     0     8     3     1     6    13     8     4    12    23    11    18    10    25    11     7     4    22 
    4     1     4    24    23    17    10     5    11    15    10     9     4    22     9    12     5     0    10     4 
    4    22    11    13    10     7    13     1     1     2    15     5     8     0    23    24    18     9    11    20 
   19    22    15    23     3    10    15     9    25     3    15     0    19     4     8    11    24     4    20    19 
    5    23     4    13     9    20    17    15    25     9    23    12    15     6    22    23    11    11    10    24 
   17     3     6     0    23     7     8    17    15    22    23    11    11    24    16     1    13    16     8    13 
   14    23    13    11     8     6     7    16     8    19    10     4    19    16     2    14     0    23     3    19 
   10    15    11     6     7    22    14    22    14    15    16     9     6    13    15     1    11     1    12    16 
   16    18    13     1    25    18    15    20     7     7    22    13    19    10     5    22    17    10     0    23 
   22    25     3     9     4     7     2     2    10    13    16    16    15    14    17     0    20    10     9    15 
    9     3    25     0    15    18    12     2     5    19    12    24     1    18    15    11     2     9     3    17 
   18    20    10    18    15     3     0    22    20    23     3    13     9    19    17    21    25    21     6     2 
    8    25    13    11     4    20    21    20     8     5    20    21     3     5    20    25     0     7    23    21 
    1     0    10    13    15    14     0    16     7    19    14    24    24    22    19     8    16    18     8     7 
   25     1    12     2    22     7     9    23     0    21     4     7     8    18    19     9    17     8     0    16 
    4     0     2     6    22    25     9    13     6    24    22     4    18    10     0     8    10    13    11    16 


   24    20    20    20    12    24    18    18    22    17    15     9    16    16    12    17    12     3    13    13 
   20     6    10    23    15    22     0    22    18    14     9    21     2    10     2    19    13    20    23     5 
   18     9    21    13     0    11    16    25     5    12    16     3    19    21    15    21    14    10    11    18 
   18     0    20    13    23     6     8    11    15     5    24     3    10    11    19    13     3    22    18     7 
   17    10     3    25    24     9    24    19    12    23    20    23     1    15     2     6    19    13     3     8 
    5    16     7     7    10     8    21     1    22    20    22    12    10    24    25    13     5    22    10     3 
    7     8    19     5    23     4     3    20     9    19     4    23    10     4     0    13    15    10     6    19 
    6     0     4    22    22    25     3    18    10     4     3    16     4     1    12     7    12     8    25    14 
    2    18    15     4     7     9    21    20     9     2     9    12    21    24    21    12    19     4     2     8 
    1    20     5     5     0    11     3     2    25    21    24    21     9    11    12    18     8    11     5    22 
    1    23     4    22     3    24    25    16     3    19    17    19    15    11     1    20     8     6    23    18 
    2    21    19     2     2    23    14    11    24    10     2    10    14    17    11    14     2    23     4    11 
    4     1    12    24    18    12    20    10    22    22     4    21     8     2    18     8    17    20    17    20 
   16    19    19    12     2    23     0    14    13     3    18    21     0    19    19     8    21    16     3     6 
   20    23    22    14     1     5     6     2    12    24     0     6     7    12     4    12    24    24    20    12 
   22    25    22    21     0    11    13     2    14    17    14    17     2     0     0    23    23    16    17    21 
    2    19    25    24    25    10    21     6     2    18     4     6    12     7     7    20     9     8    23    24 
   14     1     0     2    14    18    25    20     6    14    20     3     7    19     7    10    12     5     2    16 
   19     7     0    24     9    25    11     8    14    12     7    12    22     2     9     3    24    19    11     9 
    0    19    13    14    21     7     8    21     4    11    15    24     9    20    17    12    18    11     1     4 


