 1761  1454  1798  1911  1858  1859  2143  1536  1611  2376  1740  2541  1778   963  2277  1938  1772  1386  1512 
 1199  1882  1994  1270  2486  1447  1158  1348  2078  1552  1967  1735  1903  2447  1656  2039  1791  1683  2046 
 2554  2407  2369  2404  1869  1376  1705  1880  2017  2063  2426  1955  1567  1552  2562  1203  1809  1215  1121 
 1590  2065  2213  1720  1525  1887  1811  2785  1774  2167  2250  2414  1741  2263  3071  1676  1968  1782  1805 
 2131  2088  1844  1523  1520  1852  1827  1866  1740  1970  1304  2482  1576  1757  1800  2653  2224  1689  1222 
 1885  2120  1898  1842  1433  2252  2075  1904  1679  1913  1591  1851  2177  1870   987  1382  1520  1806  2212 
 1571  2025   907  1716  1065  1832   809  1812  2008  1937  2471  2133  1557  1849  1479  2487  2237  2291  1862 
 2028  2357  1399  1643  1261  2147  2114  1509  2287  2524  1584  2207  1488  1545  1653  1888  1260  1199  1401 
 1467  2425  1681  1934  1451  2904  1123  2585  2261  2238  1298  1968  1312  1532  1130  1529  1881  1622  1974 
 1397  1863  2161  1816  1666  2975  1269  2367  2209  2111  1774  1427  1681  1105  1974  1953  1677  1805  2122 
 2093  1808  2632  1836  1232  1829  1605  1138  2274  2204  1719  1751  1113  1910  2188  2230  1999  2089  1923 
 2108  2019  2502  2284  1882  1758  1560   997  1861  1465  1896  2317  2262  2337  2195  2015  2753  1185  1828 
 1606  1555  1653  1829  1638  2476  1194  1112  2078  2379  1573  2142  1577  1828  1428  1531  2321  1201  1517 
 1465  1838  2010  1224  1642  2295  1506  1615  1976  1766  1897  2271  1400  2056  2011  2124  1480  1338  2096 
 2608  1397  2475  1782  1526  1777  1521  1712  1568  1781  2314  1720  2170  2281  2162  1848  1410  1246  1660 
 1953  2059  1661  1764  1054  1415  1979  1467  1345  1909  2009  1995  1056  2247  1327  1496  1117  1940  1764 
 1351  1641  1672  2109  1639  1473  1536  2144  1624   998  1632  2643  1952  2565  1380  1982  2222  1226  1946 
 1897   969  1699  1484  2068  1397  1567  1687  1848  2188  3000  1668  2509  1370  2594  1823  1800  1486  1791 
 2167  1342  1947  2262  2076  1863  2163  1176  1460  2011  1935  2241  1826  1869  2360  1952  2406  1754  1520 


