    5    19    12     8     7    18    15    18     1     3    18    14    11    21    12    14     1    11     0     6 
   25     9    14    15     3    21     6    21    10     8     4     2    14     1     5     4    19    23    13    23 
    4    25    10    16    10    25    12     4    11    25     6    16    23    23    13     5     8    24     0     8 
   17    24    21    13    19    16     6    22    10     3    25    10    14     6    12    22     4    10     4     3 
   11    11     8    20     1     0     4    19     5    10     8    10    13    15    12     5    13     3     1     3 
    8     5    24    14    21     8     4    16    17    22    10    14    11    13    14     2    24     5     8    18 
    0     3    15     4     8     9    10    19     9     8     1    10     5     4    17     1    10    11    20    17 
   24     8    13     3    14    20    17    23     1    13    18     1     1    21    10    22    12     9    22     6 
   21    18    20     0     3    16    25     3    25     9    12    24    25    20    22    10    22     3    17     0 
    6     0    14    21    25    11    13     1    25     9    16     7    23    18    17    16    21     5    23    17 
   13    11    22     4    19     1    14    23    17    18    19    18    20     4    15    13    25     8    14     7 
    6     2     9    22    19    15     4    25    21     0     3     5    23     0     5    11     7    16    17     7 
   23    23    22    12     1     2     4    10    17    17    22     0     4    10    10    22    15    11    12    18 
   10    15    13    11     3     1     1    16    22    22    18    18    22    21    23     4    18     7    25     9 
    0    25    15    12     3     0    15    16     2    11    13    24    23    24     7    17     2    21    23    24 
   23     3    13    17    17    18    20     6    19     6    18    25     7    19     7     5     7    10    11     9 
   18    22    13    12    19    17     8    19     3     4     1     3    21     1    13     3    13    16    22     6 
   12     0    25     6     4    24    25    11     9     2    19    25     5    24     4     7    18     8     4    22 
   19     8     8    12    20    18    17    25     1     4    14    12     2    25    12    25     3     4    14    17 
   24    17     1     3    13    15    14     3     1     4    15    11     5     9     4     8    19     1     2     6 


    6    18     9    10    20     2    23    15    22    10     8     6    17    13     9    24     4     8     2    24 
   17    12    10     6    25     2    17     8    25     7     4    14    20     9    14     6    21    17    23     5 
   14     1     7    13    20     1    22     7     8     0     6    21    13    12     4    13    18    15    10    20 
   23    14     2     6    17     1    18    18    21    18    24    12    13    21     6    10    19     2    23     3 
   17     2    21    11    19    11    13    12     8    24     6     6     7    19     4    18    20     7    20    18 
   12    25    21    25    11    15     8    21     7     7     8    16    20    10     5    15     0     1    15    20 
   15    11    25     3    23     4    22     7    20    16    21    19     4     8    24     6    24    16     9    24 
    2    15    18    15    21     1     7     6     1     9     7     2    23    11    22     3    20    24    13    21 
   14    11     2    24    20     9    22    13    20     0    10    12    13    23    23    20     6     8     0    22 
    7    18    24    16     0     4     4    25    11    21    19    14    13     9     0     3     7    13     2    21 
   22    10    11     0     3    13    19    25     1     6     2    22     1    11    14     0     5     3     8     2 
   10     5     1     3    14    17     3    16     0     7    16     0     9     1     1     3    24    14    20    10 
    8    15    25    25     9     4     3    14    25     4    11     6    18    25     7    21    19    12    18    21 
   15    17     8    23     5    13     3    23     3    11     4    22     1     2     0    15     7    12    22    25 
    1    16     9    14    16    11     5    22    11    15    21    23    17    22    15    19     3    22    21     8 
   23     4    17     1    17    11    21    12     8    18    21    19     7    15     4    21    20    14     6     5 
   17     0    14    22     1     7    19    22     2    17     9     4     6    21    21    21    10     1    17     0 
    1     1    12    25     7    19     4     1    13    16     9     1     0     8     0    13    14    15     5    13 
   11    17    20     4     5    24     6    25     4    17    15    11     5    15     1    23     9    22     8     4 
   14     9    21    12    11     0    21    16    25     7     8    21     9    25     0    18    25     3    18    12 


   17    24    19    18    19     8    14     7    24    15     5     2     5    17    23     0     2    21     5    11 
   21    25    17    20     8    19     7    23    17     2    23     2    19    16     6    24    16     4     7    24 
    6     7     9    25    20    18     0     5     6     2    18    18    19    24    23    11    19    24     9     5 
   16    14     5    24    24    18    19     2     3    23    10    18     1    11    25    23     8    18    14     0 
   16     7    20     4     4     1    18     4     2    15    18     1    10    10    11    16    19     3    25     9 
   25    24    13    21    21    13     7    16     4    11    22     4    10    17    24     6    12    16     4    11 
   19    23    15     6     0    14     7    22     2     7     5    14     9    15     3    14     2    25    22     3 
   21     1    17     9     7    14    24    25    17    22     4    21    12     0    24    16     8    23     6    24 
   10     5     7     9     3    12    18     6    21    10    17    23    14     0    16    22    10    19    24    17 
    2     2     7    13    11    20    22     9     2     6    15     2     7     9    14     8     6    12    14     1 
   18     3    12     5    15    14     8     2    10    19    24     2     2     4    19     4     2    22    13     7 
    0     5     8     3     9     3    24    22     3    16     6    18     5     0    13    23    10    16     4     6 
   13    12    24    21     4    24     5     2    25    14     3    22    18    19    24     8     8    25     1    13 
   24     9     5    25     6     5    15     7     8     4    17    14     4    15     6     2     7    14    14     5 
   21    21     0    19    20    19     3     7    16     2     1    20    23    13    18     8     9     0     4     7 
   21    22    10    15     7     8     4    14    11    15     4    13     5     0    25    10    16    21     3    12 
   11    17    19    24     2    15    21    25    16    23     1    17     6    22     1     9    24     9     4     8 
   21     3     4     2    14    18    11    11     6     4    24    18    21    11     8    25     2    22    17     6 
   22    23    17    17    22     4    25    11     3     0    12    25    12    11    10    10    19     1    17     6 
   24     5     2    19     1    12    18    10    19    17    16    11    15     1    20     5     5     1     9    19 


    9    11    24     8    11     4    10     5     1     0    12     6    19    25     8    21    12     9    10    11 
    3    22    17     7    13    19     9    25    20     8    14    25    14     9     4    16    19     4     8    16 
   18     6    22    20    23    23     7    14    15     3    20    12    20    20    16     7     7     1     6     1 
   11     5    14     0    23    11    12     3     4    10     2     6     8     9     4    16    13     9     7    17 
   17    23     6    23    17     5     0     4    21    12    25    18     7     9     9     2     2    16    14     4 
    6     4    18     8    25    21    11     2     6    11    11    17    15     1     1     1    18    18    17    17 
   17    24    21    17    12     8    18    15     1     0    21    11    15    15     9    19     6    13     7    14 
   23     3    22    10     3    13     5    17     7    12     8    15    20    25    16     1     1     7    18    18 
   15    22    16    24     1     9    20    19    25    24    18    13     9     2     7    12    20    19    22    24 
   15    14     7    22     5     4     8     3    12    23    20    13    25    11    11    17     0     6    17     6 
    6     6     2     1    22    14    23    19    16    14     1    13    13    22     6    10    19     4    19    10 
   23     8    10    20     3    17     7     1    22     3    21    17    12    13    19     8    22    15    20    22 
   17     9    11     4     7     0    22    23     3    17     9    22    12    15    17    25    14    14    12    18 
   21    24    16     4    23     9    14     3     7    25     9    23    11    20    11    13    10     1    15    21 
    5     5    12     9    19     7    14     4     5    25    25     5    11    16    12     3     4    19     4    13 
    1    14    13    12    12     5    25     6    22    20     4     5     0    11     3    16     7     8     1     6 
   12     1    20    18    24    14    13    20     3     8    17    20    25    13     2     5     2     2     3     7 
    6     6    23    13    18    17    25     7     5    15    16    15    13     4    12    17     4     8     3     4 
   18     0     6    10     4    17    24    14    17    23    17    22    20     7    10    15    25    12    22     4 
   11    16    20     5    20     2    25    18    22     4    12     2    24     9    20    24    16    16    23    11 


   20    15    14    17    11     5    15    17    14    15    25    11    18    11     3     4    15     5    20    23 
    9    14    12     0     1    14    24    19    20     2    24     5    17     3     6    18    22    16     6     3 
   24    22    13    18    11     1     3    13     0    21     6     4    18     3     1    12     5     8     6    17 
   23    23     1    12     0     7    18     0     7    25     9    12    23    22    16    19     8    11    18     4 
    3    22    16    14    13     9    18     4    22    23    18     4     1     7    18    12    14     4    24    10 
   24    19     0    12    16    24    11    14    17    22     8    19    11    11     0    10     3    13    16     7 
    2    24     0    24    17    12    15     3    18    10    10     9     5     7     2     3     7     7     5     7 
   14     3    25     2     0    22    22    13     0    14     0     2     8     3     8    19    25     5     3     5 
    9    24     9    18    12    20     5    21     1    20     5     8     1     9    20    23     8    18    23     7 
    0    20    25    14    16    12    18     2    20    21     7     8    19    23     0     1     3    15     2    13 
   25    20     6     0    21     3    23    12    24     7    20    10    13    24     9    10    13    22    15     5 
   13    22     4     8     2    17     5    25    14    11    11    14     5    13    13    10    11    20     9     2 
   15    15     1     7    18    11     3    21    16     0     0    24     3     7     4    10    12     4     7    22 
    6    10    14     8     2     8     1     1    13    22     4    11    22    21    14     9     6     0     7     0 
   15    25    18    21    25    15    23    24    13    16     7     9     0    25     0    22     7    24    14    10 
    2     3    17    25    12     9     8     2    25    22     0    12     0    22    22    17    23    12    10     5 
   12    20    13     4    21    10    13     4    10     8     2    22    10     2     5    17     3     6     2     7 
   14    12     4    19    13    20    14    16    11    14    23    19     8     3    12     1    15     5    24     2 
   23    12    22     0     3    20    11    18    10    18    12     5     7     0    21    23     4     6     4     1 
   17    23    24    12    11    25    22     9    22    10    17    13    15     3     8    24     8    17     4    16 


    9    10    18     2    25     3    24    12     2    13    13    22     5    20    23     0    12    22     5     9 
   19     7     2    19     0    10     3     7     6     6    13    21    18     4    20     1    25    10     5    20 
    2     0     9    20    13     2     2     6    12    13    18    14    22    16    24     8    21     3     8     2 
   22    18    19     4     0    15    21    18    25     0    21    25    21     4    11     9    23    17    22    21 
    8    16     6    23    10     0     6    11     1    21    25     6     5    10    23    24     9     6    10    11 
   23    19     5    17     4    23    25     3     9    11    13    20     1    22    14    24     3    15    12    11 
   18    14     2    23     2     7    22    20    13    17    20    11     3    10     5    21    13     6     1    11 
   18     3    11     5    17    15     1    14     6    15     0     1    19     1     4    17    21    16    16    13 
    8    23    20    20    24    20    25     7    17    23    18    15     6    18    20    22    16     6    12     9 
   17     0    16    15    24    12    11    16     5     9    24     0    13    20     5    12     2    16     0    15 
   13     6    17    22     6     4    19     3    20     0    11    25    16    18    12     6    10     3     4    10 
   21    14    12     6    23    15    13    12    21    20    16    19    21    19     5    17    23    19    10    14 
   19    19    13     3     8    21    14     2     9     9     9    13    11     7     6     0    12    23     0     2 
   17    18    22     3    16    25     3    21    19     4     4     6    20    22     9    15     8    15     0    12 
   25    19     8     9     8     7     0     7    17    12    13     7    20    21    19    14     4    19     3    20 
   23    16     9    10     2    20    17    24    18     0     5    21    23    25    13     7    17    13    24     0 
    0     9    11     9    13    18     4    19     1    12    15     6     3    23     2    11     8     1     6     3 
   14     3    10     8     1     8    11    16    13    23     3    18     2    21    18    14    13    21     9     5 
    8     9    14     2    18     7     9    24    22    22    17    20    19     0    19    23     2     8    10    20 
   11    15     1     5    19    14     5    19    11    23     4    15    20     2    19    19     0    25    16    17 


   15     0     5    15    20    15    24    22    19     7     2    21     5     7     3    20     8    25     0    16 
    4    11     5     4    21    16    25     7     7    25    24    12    21     1    19    23     0     7     0     5 
    6    21     5    20    10    16     9    20    23    20    19    23    14    13    17     8     6    20    15    13 
    6    16     6    20    18     7    15     7    15    25    10    21     0    24     1    24     9     2    12    14 
   12     7    22    24    19     0    18     7    11    18    10    13    21     7     3     0    21     2    22    17 
   11    17    23    17    15    10     8     8     3    16    14    24    24    20    21     1    13     8     1    16 
   15    24     5    21    20     5    11    12    17     7     1    15    16    18     3    10    24     6    10    16 
    7    14     8    25    25    14    10    21    11    12    20    10    10     0    22     2     6    18     7    24 
   12    11    10    25    25    15     5    11     2    13     0    25    14    16     0     1    18     3     8     5 
    0    11    22    25    21    11     3    20    10    14    11    20    17    23    13     5    16    19     7     9 
    6    15    14    10    12     8    16    17    13    10    17    20    13    13     7    17     5     5     2    21 
   11    15    22    16     6    10    13    21    23     5     5    19    23    22     2     5    20    23    25     6 
   10    24    14    23    23     4    22     4    11    11     3    20     9     3    19    11    20     4    12     2 
    8    25    14    17    18     4    12    16     8    23     4    14     8    16     1    10    24     3    17    13 
    5    22    11     5     8    21    10     3    17    21     4    10     3     8    20    14    24    14    11    15 
   15    17     3     1     9    17     1     0    18    18     7    18    15    21    12     6    23     1    20    15 
   22     6    14    17    14     4    17     8     5    21    11    10     1    25     9    11     0     7    10     7 
   13    25    14    19    14    21    19    14     4    16     6     5     0     0     2    19    16     4    14    20 
   23     1    12     3     4    24    21    13     3     0    12     7    12    13    23    25     7    11     3    10 
   13     7     0    11     4    16    18     2    11    22    23    21     4    22    24     6    14     3     7     5 


   12    12    16    25     6    19    18    25    20    13    13     7     0    23    14    18     6    22     3    12 
   24     1    22     1     2     7     2     5    11    15    22     6    12    14    18    13    24    11    12     4 
   21     7    21    11     6     3     6    15    15     6    24    21     2    18     2    13     4    16    17     1 
   23    15     5    17     8    21     8     1    17     0    23    23    21     3    13    10    13    20     5     1 
   23    19    19     1    19    19     2     0    21     5     7    25     0     2    13    19    22     3    13    22 
   22     0    16     1    11    24    16    21    12    23    13     0     4    19    15     1     6    21    14     6 
   21    14    24     4     3    14    20    16     5     9    23    12    20    24    20    12    22    19    25     5 
    9     6    23    19    25    23     3    19     9    21    13    16    10    10     4    21     7    12     3    21 
   16    13    11    24    24    11     3     9     8    25    16    20     2    11    25     2     4     7     9    11 
   23     0     1     5     1     2    17    13     4     5    21    11     8    15     1    18    22    14    17     2 
   19     2    21    14     0     0     4    22    10     7    20     5     0    21     7     1     3    13    18    22 
    7     4    15    24    20     5    13    21    18    10    22     6    23     9     0    10    12     5     6    13 
   16     1    25    23    11    12     4    25     6    17    20     8    13    24    23    16     6     9    10    25 
   17     3    22    23     3    19    25    17    11     0    11     4     1     2    18     0    23    22    18     3 
    2     5    16    21    19    20    18    12    16    16    12     0    10    13     6     8     2     5    18    11 
   12    10     3     5     7    18    22    23    11    11    21    16     0    15    14    10    10    11     8     8 
   23     8    11    16    12    12    19    13    19    22     0    25    25    13     1    11    23    25     8     7 
   25     9     7     4    13    16     2     4    20    16    23     8     0     4    22     2    22     0     8    23 
    0     7    17     2    10    11    13    13    15    11     7    20    10    14    17     9    20     6     1    18 
    6     5     4     7    10    15     4    21     6     6     7     9    14    19     7    19     8     8    24     6 


