   13     6    18    12     4    18     6    24    10    11    10    14    21     1    13    10    19     3    18 
   21    11     4    19    14     5     5    20    16     6    23     1    23     9     6    18     5     4    25 
   16    13    13    15    23     3    14    23    21     6     6     9     3    10     6     7     4    25    22 
   16     3    23    18    15    12    22    19     2     3    15    10    22    25    20    17    10     3     7 
   18     1     6     7    18     7     4     5     0    22     0    16     3    10     2     6    12    20     7 
    1     3    16    15    24    15     8     9     9    15    18    11     0    22     9    12    10     3     9 
   23    10    23     3    18    13     3     6    25     1     0     4     8    22     2    23     2     0     1 
   21     3     6    10    25     4     8     9    16     4     9     4    17     9    24    22     2    20     1 
    9    25     4     7    20    24    25     8     5     7    17    13    12    15     5    10     2    25    20 
    9     3     0     2    24    23    13    10    16    25    20    24     9    24     6     1     6    24    16 
   22     1    15    18     8     5    15    20    24     6    20    18    24    24    19    14     2     5     6 
   12    14    17    20    12     5     1    18     8    17     7     7     5    24    24    13     7     4    21 
   10    20    14    20    12     1     7    15     0     5    18    21     1     2     1     6    12    16     0 
   24    20    19    15    22     4    10     5    12    21     3     5    21    15    16    16    13     4    10 
    5    13     6     0    16    12     6     9    22    21    21    23    24    23    18    22    16     0    16 
   16    13     2    16     5    11    20    10    21    15     3    11     1     5    11    10     9     7    19 
    2     4    10     2    24     4     4    10     1    14    21    10     0     4    12    10     1    13    24 
   17     9     5    17     3     8    17     7    24    14    23     9    16     2    13    13     5    17    19 
   22     2    11     6     4     6    17    24     1    21    23    20    24    23    15     4    19     7    11 


   20    22    19    24    22    16    19    17    24    15    13     2    11    23    13     0    10    10    19 
   12    20    24    14    13    18     8     0    15    12    18    22    23    18    20     8     0    22     2 
   20    14     2     8     6    12    11    14    25    21    18    24     4    21    13    10     7     1     4 
   10    24    15    20    25    10     4    14     6    21    16     2    19    14     2     9    19    24     7 
   19    10    13     0    22    15    12    10    18    13    12    14    21    17    21     5     4    25    18 
   17     7    25     3    13    21    13    19    10     9    23    12    22     1    17     0    10     7    13 
   17    19    18     4    22    23     9     4     1     4     1    12     4     4     3    22     0     7     0 
   13    15    25     0    21     2     6     9    12     2    20    17    20    16    20     4    21    14     7 
    5     1     3     8    11    12     5    17    10    25    11    25    17    23     3    18     6    20     1 
   22     2    12    11     4    23    10     2     6    23     8     4    10    18    12     8    23    25    16 
   22     6     2    15    14    14     8    20    15     6     4     4     5    24    25    20    21    13    16 
   25    14     9    25    18    25     0    25    19    13     8    17     1     3    20    14     8    25     8 
   22    11    25    23    10     6    19    13     5    25    21    15     4    20    24     5     0    22     6 
   11    23     0    23     9    19     0     2    25    16    13     3    18    12    17    18     1    11     7 
   22     0    18    25    25    21    14     0     5    25    24     0     6    15    13     0     7    16    15 
    0     4     1     7     5     5    16    15    23     3     9    20    12    23    14    13    19     5    21 
   22     2    18     8    17     2    17     1    15     0    18    19    11     9     6    10    11     0    22 
   14     6     1    12     4    19    18    17     3    17    19    24     9    22    14     7    11    21    24 
    7    13     6    20    21     1    15     1     8     2    10    11    10    12     4    19    21    10    17 


   21     2    10    23    20     3     2    20    13    16     3     4     9    23    23    17    21    12    15 
   14    24    11     4    12    18    18     3     1    22    18    13    22     7     5     4    21    12     6 
    5    14     8    16    12     7     8    23    14    22    16    10    18    21     2     6    25    13    20 
   15     6    24    25    11    12    17    13     5    20     2    11    20     1     1     7    11    13     5 
    4    12     4    10     1    14    17    12     8    18    18     6     6    20    15    12    22     6     0 
    6    12     0     9    17     4    19     0     3    12    22    19    14     3    17    23     2     5    20 
    4    19    24     5    13     6    19     1    13     6     3     4    15    11     7     2     5    14    25 
   23     8    22    25    14    17    16    19     4    20     0    18     0    21    23    11     7    19    11 
   24    22    13     1    11    15    10    16     4    11     7    17    19    14    20    14     5    14     5 
    5     0    21     9    25    15    15    19    10    15    23     8    16     4     0     0    16    17     3 
   17    25    10     9    17    21     3    12    23    14     9     0    20    23     1    16     6     6     7 
    8     1    12     3    16     5    23    18    24    22     9    22    25    12     4    10    14    19     2 
   21     7     6    15    19    25     4    11    20     4     9    12    19    20    17    13     5    14    15 
   18     8     5    25     9    18     1    11    15     5     7    18     5     9     1     3     7    17    12 
    1    15    18    14     4     7    15    10     9     9    19    14    24    20     7    20     4    19     4 
   16    24    14    24    25     3    24    20     1     1    16     2    10     1     7     4    19    24    20 
    5    10     6    21    22    22     9     4    18    22    17    17    19    17    16     3    24    24     2 
   17    24    20    13     7    24     8    17    21    15     0    25     6    25    15    13    25    22     6 
    2    17     8    12    24    10    21    20     7    13     9    24    21    15    19    23     7    15    18 


   10    17    13    19     9    10     3     1    22    19    22     4    21    11    21    16     8    17     2 
    7     8     4    24    23     1    21     8    16    25     1    18     4    16    14     5    18     5     2 
    3    22    12    19    10     5    17     9     0    18    21     8    25    12    18    10    11    10    18 
   25     6    19     4    18    14     3    15    18    15     9    20    13    10    22     9    16    12    14 
    4     6     1    23     1     8     1    16     3    21    11     0    18    23     4     3    22    18     9 
    7     7    10    20    19    22    20    12    20     9    24     6     3    15    19    22    25     6    23 
   25    15    10    23    18     2    10    21    24     0     4    10     6     0     2    21    11    11     5 
   10    25    12    24     4    13    18    14    14     7     6     4    21    16     9     2    16    20     7 
    8    19    11    12     9     5    10     3    10     5    24     0    17    23    12    19     5    11    19 
   23    13     1     4    15    21    23     3    24    24     8     1    23    13    23    20    24    11     1 
   25     4     1     5    12    24    25     2    15    24     1    10    25    11    18     9    18    21     7 
    8     7    12     2    15    18    15     8     7    16    14    22     1    14     1     6     3     9     0 
   25     8    11     2    12    13    20     8     0     4     2     7    14     6    10     4     1    19    20 
    7    20    17    24    12     4    10    24    23    10    15    17    15    18    21     0     5     9    13 
    0     0    23    13    14     4     3    15    17     8     4     4    18     6     1     0    20    19     9 
   12    20    16    21    10     1    21    25    19    10    12    17    13    18     6    17    22    25     0 
   17    15     2    24     3    15    23    25     0    16    21     3     2    23    12     4     0     7     6 
   14    16    14    17     5    25    15     6    25     0     9    25    13    20    20     4    14     8    21 
   20     9    25    17    11    11    23     9     2    21     5     7    25     4    17    15    15    10     6 


   15    19     1    19     2     6    23    23    13     3    15     5     8    23     4     3    12     3    13 
    6     3    13    18    10     6     0    19     3    11     6    19    15    10     0     2    24    15     8 
   11    13    10    13    22    14     1    21     3    14     2    21    16     9     9    11    11    17    21 
   13    19    22    20    25    18    13     3    12    14     0    18    16     8     4    21    15    23    20 
   11    15     4    24     4    24     4    14     8    13    10    16    25    17     8     1    22    23     7 
    0     9     6    22    12     0     7     2    20     3     9    25    18     0     8     7     9    10     2 
    2    15    21    12    14    19     8    11    23     8    24    21     0    19     8     5     5    15     8 
    6     6     6     1     3    11    19    12    12    19    14     0    15    13    24     7    23    10    20 
    7     1    19    18    15     2    16     5     3    13    16    13    11     5     2    10    22    11     1 
   14     7     0     6    21    18    16     3    14    17    10     0    25    12    17    14     3    20     8 
    6    21    13     5    10     5     6    25     5     6    10    24     0    23    13    21    21    23    22 
    2     9    20     2    16     7    17     6    17    17    11    17     8     6    16     8    10    19    21 
    3     3    15    19     4     5    25    23    24    12     0     6     9    19    21    23    19    14     1 
   13     9    21    16    11     2    14    12    11    10     8    14     9     7    23    10    12     4     0 
   23    15     5    11     5    24     7    18     8     2    17     2    19    20     8     9    22     5    15 
    5     6    15     7     0     6     0     6     1     8    13     5    14    25    14    17     8    10     0 
    2     4    11     2    19    10    21     9     0     2     9     1     6    14     2    23     6     8    24 
   19    17    15     1     0    10     6     4    15    20     8    16    24     9    20     6     3    11    24 
   20    21    10    11    24    20    23    14     8    11    25     8     0     4     5    18    10    16     3 


   11    10    21    18     3     2    23    12     2    12     4     8    15    20     2     9     9     4    22 
   15    24    11    19    22     8    18    19    12     0    17     3    25     0    14    18    17    22    15 
   19    18     8    10    17     2    18    15     2     7    17    18     3    16     7     2    10     2    12 
    9     9    12    12    21     1    17     2     0    10    18     3     1    15    10    18     1    25    13 
   22     8     1    10    22    19    22     5    23    24    22     4    20    21    11    17    15     0    13 
    6    21    20    21    25     5    25    19    23    16    14     7     6     9    18     8     8     4     2 
    4     7    25     1     5     4    22     4     9    12     0    15    24    21    23     8     8     9    14 
   14    15    24    21    13    14     9     4    24     2    21     4    12     2    21    21     7    24    16 
   11     1    16    18    14    12     2     7     2    19     4    15     8    17    24     6    15     4    22 
    1    17    19     6    18    24    16    16    18    10    15     9     7     8    24    24    22    22    17 
    3    19     5     2    19     8     9     4     2    18    18     7    19    15    19    22    16     7     4 
   19     1     7    13    17    10     9     2    10    14     1     7    21     3     6    20    15    16     8 
   22     6    13    14    17     0     5    12     9    23     4     5     7    11    10     9     6     1    18 
   18    14    12    23    15    20    15    20    17    22    10     8     2    13    17     8    20     1    18 
   13    12    14    16    14    22     7    24    20    10    15     6     5    17    18    14    23    24     0 
   23     0     7     5    25     6    23     6     2    16    16    23     5    14    17     3    17    18     3 
    0    23    14     1     4     1     2     6    13     1    20    18    19    18     7    11     7    11     7 
    7     9     0     8    18    18    19     6    19    14    17     0     6     1    17     0     8    19    20 
   22     4    15    23    24    20     1    20     8    12    18    22     0    14    14     4    16    18    10 


    6     8     5     8    19    19    11    16    24    19     4    11     9    10     6    24    19     5    25 
    8    14     2     2    20     5    18    19    18     0    25    25    23    12    16     1     0    12    21 
    8    23    23    24    18    20    18    22    18    24    25    16    20     7     7    12     1    23    20 
    9    14    24    10    11     6    17     4    21    11    21    12     7     6    16    19    18    20    16 
    5     7     3    25     2     3    11    24     7    12     1     7    24     4    20     6     5    10     1 
   16    24    10     8    20    10    12    12    14    10    17    12     9    11     4    23     9    17     3 
   13    18    20     0     4    23     9     8     9    16     6    23    15    24    11    10     9     7     6 
   15     0     2     5     4    12    10    19    13     7    16    17     1     1     9     9     4    23    20 
    2    11    17     5    24    15     7     1    10     9    18    14     0     7     1     9     4    15    12 
   11    10    18    20    24    16    10    24     1    11    16     9    21     8    13    10     8    21    25 
    2     8    20    21    18    20     0    13    10     6     3    18     0    13    10    17    24     3    19 
   10    17    23    10    24    25    16     1    11    23     1     5    13    21    25    23    17     1    13 
   14    18    16    22    20    16    15    24    23    12    17     1    17    10    18     2     5    11    11 
    9     0    13    19     7    12    21    17     2    25     8    25    14    11     1    18     6    19     6 
   10    24     9    20    24    24    24    14    14     5    23    18    17    15    21    16    17     3     2 
   10    17     1     4     2     2     2     5    11     1    19     5    20    20    11     7    17     6    20 
    2    20    19     2    15    23    23     0    12    17    23    10    24    20     6     5    23    12    18 
    0    24    14    18    17    12    15     6    11     0    10     0    17    15    23    17    21    14     5 
   19     9    18     9     0    16     4    22     6     1    10    24    15    18    12    22    23    16     9 


   24    10    13    19    24    21     1    19     3    18    14    12     2    19    18    20    20     0    24 
   11     8    15     1     4    13    14     4    18    23    25    11     8    19    11     5    15    23    12 
    5     9    10    19    24    24     6    17    25     0     5     5    25     6    22    11     3    16    25 
   24     5     3    17    23    11     9     0     3    12     8     7    19     6     3    16     5     4     7 
   15    17    21    20     7     2    12    21     7     6    21    23    18    18     8     3    14     1    23 
   24    21    19    18    13     9    24    23     7    23    11    18    11     9    23     4    17    10    14 
   11    18     4    24     9    19    21    11    20    22    10    22     7    16    17    24     5    14     2 
   18    14    20    24    10    12    17     4     6     3    25     9    22     2    20     6     6     2    19 
   11    13    12     3    25     1    16     1     4    22     3    20     7    22    11    24    14    24     0 
   25    10     9    23    20    18     7    13     5    17     9     7     1    22    14    14    22    13     1 
    5    16    20    13     9    20    19     9    17     2    10    21    13     6    21     4     6    25     2 
   19     5     9    17     5    13    10    11     7    18     1    23    23     9    25     7    17    16    18 
   21    18     8     2    17     2     5     5     0     6    19    24    25    14     9    21    21    13    23 
   11     6    21    12     8     1    23    22     6    21    23    20    20     4     2    20    10     3    19 
   14    25    16    25    15     8     3     1    15    16     9     7    16    24    21     9     7     4    11 
    3    24    23    23     6    13     4    25     0     0    13     3     3     1     0     8     7     5    24 
   23    14    13    17     3    17    10    11    11     6     7    15    13    15    12    24    18    21     3 
   10    14    22     0    15    10     3    16     8    19     2    20    15     8    10     8    10    10     2 
   18     6    25    15     6    22    10    19    22    16    23    24     8     5    13    20    15    19     9 


