   37    50    49    16     7    25    36    49    26    30     2     3    35    23    16    44    16     3    41    44 
   12    18    35    33    14     2     3    10    10     9    45    26    25    24    10     6    18    38    31    32 
   34    43    25    20    40    11    29    19    30     5    26    47    14    21    45    13    28    36     3     4 
   41    46    34    15    22    24    43    38    24    17    34    21    46    30    29    45     2     3    22     2 
   27    31     4     6    41     7    32    27    27    37    15     3    22    20    11    23    45     2     1     2 
   29    44    36    37    14    32    27    36    33     3    25    19    44    49    42    49    31    22     7    16 
   30    22    36     4    10    49     8    46     6     2     1    47    29    34    40    31     5    36    20    21 
   40    47     8     8    13     2    45    10     4    47    31    28    22    41     5    50    17    32    47    23 
   13     6    14    37    37     8    16    19    11    16    18     1    37    32    48    23    23    46    21    19 
   12    26     9    28    13    24    38    15    29    22    33    14    10    37    15    20    45    39    20    12 
   10    39     6    48    24    47    34    17    49    35    13    48     9    42    37     9    30    24    33    44 
   23    28    42    18    11    37    29    14     8    36    47     2     9    37    49    31    49    28    50    40 
   12    37     7    17    10     7    15     6     6    45    26    11    33    31    10    17    35    32    28    14 
   17    26    24     1     4    28    38    39    50    45    49     3     9    34    24    15    15    47    23    40 
   48    49    12    33     2    49     2    13    32    28    15     6    10    15    39    14    34    33     7    35 
   28    37    46    24    35    43    47    36    32    42    41     3    44    15    16    26    42    49    12    48 
   18    34    35    14    31    21    49    33    22    13    41    36    29     4    44    48    49    40    33    39 
   36     9    38    12    48    33    50    16    21    32    26    50    11     8    46    31    16    34    17    40 
   26    49    44    41     2     4     8    26    14    33     2    29     3    49     2     9    17     4    13    14 
   23     7    20    33    47    43     7    30    11    14     7    12    42     5     9    49     6    10    13    30 


   26    29    41    19     2    18     1    20    36    34    43    45    45    43    24    42    30     8    48    33 
   45    22    39    27    33    27     9     4    10    45     2     7    24    41    34    19    43    23    20     7 
   33    48    28    24    28    49    14    47    45    45    41    21    12    32    21    47    20    46    31    31 
   46    49    20    39    24     7    21    42    31    20    41    46    34    41     7     7     3     6    25    47 
   26     5    45    36    33     6     1     3    10    40    22    28     7    32    40    48     7    24    42     5 
   10    42    17     6    43    28    12    23    17    48    26    44    34    49     7    32    18    47    22    44 
   49    23    26    12    12    29     9    47    20    37    11    16    48     1    26    15    16    35    50    14 
   27     9    23    20    25    39    50     3    34    23     9    46    29    29    40    10    34    15    17    19 
   23    41    39     5    47    18    41    47    24    12    44    49    31    25    44    26    48    45    13    34 
   13    48     3    23    23    18    13    18    12     2    45    31    13    19    23    35    45    32    24    48 
    6    48    31     5    17    33    42     7    20    21    14    44    36    34     7    46    46    24    46    44 
    4     2     4    34    11    40    26    47    50     5    18     9    13    29     4     7    19    49    26    13 
   44    29    22     9    46    13    39     3    17    47    39    40     1    33     8    50    47    15    43    49 
   23    24    42    13    45     9    47    47    27    16    29    21    48    41    33     3     1     6    45    47 
   33    17    12    47    27    33    33    11    46    41     7    27    41    42    10     5    41    36    26    38 
   29    10    25    36    40    29    12    38    35    40    45    50     6    50    33    11    42    34    11    48 
   17    36    28    20    42    30    23     6    42    24    13     3    15    28     4    50    33    37    11    43 
   46     9    17    20    40    38    36    17    49     4     4    40    30    49    33    29    24    18     4    38 
   18    15     2    47    16    24    36    22    29    38    43    14    25    16    11    22    13    31    45    29 
   14    22    22    50    13    14    21    45    11    39    20     3     7    14    30    23    12    13    17    26 


   39    45    17    43     5     6    15    41    47    20    11    36     9     8    45    20     4     1    46    22 
   47    25    45     7    15    21    45    34    50     1    32    44    28     7    16    12     4    27    21    47 
   17    38    13     5    18    24    33    48    41     1     2    49    46    12    43    12    46    45    38    35 
    8    39    24     9    17    35    39    46     1    50    40     2    35     6     7    17    43    45    40    48 
    6    41    34    42    19    30     7    43    34    35     1     2    41     2    19     7    31    14    23    41 
   45    46    21    45     7    47    19    19    19    30    38    43    23    38    48     3     4    40    50    32 
   18    31     3    32    39    13    18    14     6    38    36    10     4    45    14    17     2    38    49     2 
    9    50    30    14    26     8    25    25    17     3    37    16     9    19    30    46    14     5    27    48 
   13    25    35    21    44     8    32    50    48    15     4     7    39     9    25    26    49    48    16    22 
   47    38    40    30    44    26    34    16    43    48    29    16     7     9    14    41    50    33    43    12 
   20    30    50    43    17    48    29    36    25    32     1    26    24    15    34     6    28    19    16    25 
   29     5    43    28    17    13     2    46    35    49    34    25    29    19    47    25    35    29    36    23 
   14    26    44    19    43    41    28     5    41    45    43    19    33    20    32     9    22    33    26    48 
   44     7    11    49    25    41    37    27    13    32    29    36    38    36     1    33    44    25    36     4 
   27    41    34    28    50     9    18     5     3    43     4     4     2    50    39    48    17    45     3    19 
    4     4     9    41    48    31    30    13    42     1    25    28    44    10    36     9    23    45    10     4 
    3    27    31    25    28    18    33    41    11    15    16     8    37    27    39    48    29    31    11    48 
   25    36    17    15    23    45    37    38     5    15     3    41    44    43    38    20    11    20    20    46 
   43    31    42    13     8    43    18    43    14     3    41    28    50    46    11    49    45     3    30    33 
    9     8    11    46     1    43    36    48    36    29    14    11    43    15    39    32    47    38    47    17 


   16    13     6    15    36    23    31     1    36    16    20    34    12     5    44    38    10    22    18     6 
   18    13    16    39    48     1     1    40    31    10    31     2    19     3    47    11    50    20    35     7 
   10     6    40    29     8     5    48    10    21    14    29    33     7    29    18    50     3    16    47    48 
   42     3     2    22    41    20    43    45    40    11    22    48    39    18     1     6     4    37    32    43 
   45    45    16    48    41    47     5    42    50    11    45    25    11    15    25    26     4    44    26    39 
   28    25    37    35     3    33    37    33    45    17    39    17    31    39    20    23    12    39    16    25 
    9     9     3    40     4     8    39    45    46    38     4    14    28     7    23    45     8    18    13    48 
   10     4    14    34     6    42    32    28    29     3    17    27    43     6    11    41    10    46    23     8 
   24    27    17    23    44    28     1    44    17     1    37    34    14    43     5    47    49    13    48    20 
   29    20    11    11    11    26    38    42    32    31    17     8    46    18    20    25     1    37    14     3 
    6    49    24    22    39    13    20    42    27     2    29    46    29     9    26    19    34    10    41    11 
    3    21    24     5    42    29    12     6    22    30    35    39     9    39    12    49    11    29    21    23 
    5    26    11    32    18    13    43    38    10    11     2     2    38    16     7    28     7    15     8    14 
   14    36    50    49    44    11    36    25    46    25    22    24    49    24    10    47    30    36    23    35 
   40     6     6     9    43     7     7     7    47     9    27     6     3    26    43     3     8    33    46    32 
   39    27    18    19    31     7    14    42    12    46     9    12    23    48    44    18    37     6     9    50 
   40    20    32    49    31    19     7    45    34     5    42     4    13    48    17     7    29     3    19    14 
   10    45    26    25    17    40    21    21    50    30    40    12    18    18    36    19    38    35    13    21 
   34    15    18     5    24    27    50     2    40    35    18    17    49     2    27     7    31    46    36    20 
   32     2     2    41    27    32    13    24    21    10    10    37    33    47    13     8    43    40    30    37 


   14    23    41    18    31    46    33     2    27    30    29    32     7    24    41    34    34     1    13    30 
    3    30    35     4    37     4    43    30    19    42    38    36    26    31    15     5    22    31    43    40 
    6    33    15     6    30     4     5     7    23    21    25    27    46    48    20    38    15    35    44    34 
   13    34     1    41    34     7    31    18    20    10    24    29    37    21    28    38     1    14    45    24 
    3    14    13    46    31    37     4     9    18    26    48    42    31    13     6    50    34    42    31    50 
   31    24    35    21     5    25    32    13    39    27    45     7     1    41     5    19    35    21    38    14 
   39    26    35     6    16    40    19    45    25    46    16    30    11    42    25    35    46    24    10    30 
   20    19     8    18    49    47     4    12    16    42    23    21    19    17    14    20     3    27    38    44 
   46     5    19    32     9    20     8    44    12    22     6     7     8     1     9    18    29    25     1    28 
   47    18    28    48    42    12     6    25    20    26    36     7    26    12    41     4     9     8    16     6 
   43    36     7    31    24    17    47     8    45    31    35    32    46     9    43    31     8    25     9    29 
    6    24    12    38    37     3    13    21    14    44    43    35    37     4    33    16    48    50    24     9 
   21    45    35     2     5    33    33    19     2    35    17    12    42    16    17     3    40    13     5    42 
   32    29    32     7    47     4    26     9     1     2    17    28    11    48    48    32    17    13    27    37 
    3    25    49    19    33    26    49    31    13    46     4    10    25    29    42    48    26    30    44     6 
   12    32    32    34    19    10    43    30    38    13    39    20    11    32    17     4     6    42    27    21 
   36    17    27    28     8    49     4    37    26     7    19    48     9    28    10    23    32    41    24    45 
   24    22    36    23    35    13     5    30    44     5    44    18    29    31    18    39     9    13    14    14 
   44    43    37     6    28    18    24    27    10    14    28    32    24    41     2    33    18    28    42    22 
   37    43    27    44    18    35    35    50    24    36    10    41    46    42    11    50    17    27    43    47 


    7    49    20     4     7    42    21     3    10     3    14    39    25    24    27    41    18    27     6    18 
   35    33    44    18    28    17     3    43    32    43    21     4    17    10    41     5    34    37    10    45 
    6    35    14    47    47    43    20    37    16    40     7    32    25    19    13    29    35    10    37    37 
   14    50    25     7     9    36     7    37    16     4    47    45    16    50    17     2    17     5    25    44 
    5     6    47    27    21    47    39    46    12    46    42    49     6    36    15    47    35    17    11    18 
   31    48    13     4    37    14     6    13    15    15    27     1    48    30    13    16    36    36    21    39 
   24    24    18    39    47    16    44    16    27     7     2     9    40    18    41     3     1    11    22    16 
   37    30    39    21    36    41    24    16    26    43    45    24    37    40     7    49    12    40    10    29 
   22    35    47    33    28    35    11     7    44    46    31    16    44    28    42    39     8    33     9    14 
   38    45    44    47    14    45     3    49    37    13    10    34     7     5    19    38    10    32    27     3 
   27    19     4     2    20    10    24    40    29     6    41    20     8    42     3    43     4    27     3    38 
   25    28    10     5    14    18    13    31    38    21     2    33     6    19    48    25    13    24    20     9 
    3    45    16    13     3     6    20    29    24    17    35     3    23    11    10    49    45    39    18    45 
   19    12     4    42    41    23    34    27     3    33    49    35    25    50    37    11    16    11    34    50 
   35    15    48    47     6    30     8    38    49    17    43    26    19    22    20    48     4    24    18    32 
   15    27    13    14    46    50    14     1     4     8    17    17     3    16    26     5    39    32    12    35 
   23    38    27    45    43    29    38    50     2     6    22     2     4    25    41    17    34    45    42    35 
   33    37     6    40    32    12    18    27    13    21     9     7     6    43    25    46    48    35    25    16 
   11    10    22     2    32    17    30    21    13    11    15    31    13    41    31    19    10    16    31    14 
   13    48     8    46    12    38    31    26    44    40    46    18    27    40    16    34    40    19    27    38 


   36     3    10    29    16    36     4     9    32    10    15     7    42    28    37    32    15    42    35    42 
   44    39    25    11    30    22    33    30    28    27    50    49    26    25    47    24    15     5    48     1 
   12     8    49    12    26    17    29    46    34    32    27    24     4     6     5    29    36    46    31    46 
   26    11    31     4    28    26    17    31    35    21    46    50    20    23    32    38    16    40     2    22 
   36     6    21     6     9    49     4    12    18    23    50    15    28    14    26    31    47    19    26    37 
   27    21    38    11    19    39    16    41    23    42    21    31    13    10    36    12    35    30    48    43 
   39    50    37     7    16    39    29    13    47     1    41    20    39    16     9    40    19    19    41    34 
   32    30     1    32    20    36    44     6    26    40    45    30    12    22    46    24    11     3    31     2 
   35    38    10    38     5    39    37    21    23    41     6    49     9    15     8    35    26    37    41    39 
   24    19    45    43     2    14     3    42     1    23    50    42    31    42    17    38    18     5    14    21 
   38    26    46    48    11    47    17    34    14    23    40    33    22     1    43    32    29    11    13    34 
   36    31    10    10    42    12    10    30    26    31     5    37    46    27    19    39    45     1     9    35 
   28     5    31     5    24    45    13    33    12    28    50     1    49    28     5    25    14    29    34    30 
   35     3     6     5     2    20    46    48    47    13     6    37    47    40    29    29    17     3    19     3 
   39    12     4    11    31    11    24    50    16    30     8    12    26    38     4    48     2     1     5    43 
   34    24     9    40    20     2    28    23    31    34    42    16    44    12    36    38    50    28    11    13 
   49    44    47    11     4    10    39    39    34    42    37    19    46    18    27     3    33    14    26    43 
   10     5    36    19    23    38    22    24    40    39    10    13    22     8    19    24    38    50    27     3 
   10    28    39    19    29    33    23     5    30    37    40     6    29    24    32     2     9    39    25    39 
   42    32    33    46     9    41     8    37     9    10    11    32    31    14    39    44     4    18     3    11 


   37     3    30    25    41    31    12     2    41    40    43    12    33     9     7    18    45    25    39     1 
   41    44    38    44    47    44    45    13    17     1    24    13    44     4    10    12    19    28    23    24 
   20    11    21    10     7    49    14    29    32    38    26    14    36    14    23     8    11    46    29    43 
   28    32    22     8    13    24    43    45     3     9    48    13    43     6    30     2     6    25    47    35 
   30     4    45    28    32    37    28    33    24    41    26    24    38    31    34    39    21    37    34    28 
    9    36    40     3    27    19    21    23    10     6    27     6    29    34    37    26    24    47    33    33 
   27    15    29     9    38    45    23    28    17    38    39     9    15     1    44    43    16    33     4    44 
   16    50    34    23    45     8    43    41    39    50    42    33    46    12    45    25    44    21    35     4 
   28     8    20    17    41    50    39    22    30    16    50    16    34    20    45    32    19    38    42    25 
   12    19    33    42    14    19    16     7    12    31     7     2    19    44    28    12    25    41    37    48 
    1     6    27    20    18    40     5    11    15    20    25    44    34    24    40    48    32    18     5    13 
   48    35    45    28    32    15    28     7    38    32    13     6    12    25    45     5    50    33    36    43 
   14    29    41     7    42    21    49     8     5    19    41    11     2    50    31    28    12    44     9     2 
   30     5     6    21    39    45    35     8    30    50    30    10    41    14     7    34    19    36    33    47 
   24    26    19    44     8    28    43    44    28     4     2    32     9     6    19    22     3    44    25     2 
   47    26    19    29     7    15    30    26    47    31    48     8    33    16    31    39    25    47    16    32 
   21    12     4    29    40    10     7    46    25    39    47    11     5    25    20     4     5    27    33     4 
   27    48    43    15     1    41    22    24    26    23    48    31    31    31    38    49    11    10    24    29 
   47    15    21    47    21     2    12    44    23    35     6    21    29     5    49    35    32    17    30    46 
   39    43    31    21    14    35     6     3    40    12    30    40    49    44    15     8    27    40    16    21 


