    9    18    44     7    34    13    38    47    30    16    32    38    38     5    39    31     6    36    29    36 
    4    36    32    49    19    35    42    27    48    33    22     4     6    40    47    25    46    12     3    47 
   42    49    29     6    44    20    15    34    16    46    32    17     7    43    23    31    43    13    27    29 
    5    17    10    49    15    45     7    23    39     1    46    22     1    31    16    26    12    16    26    36 
   20    25    22    39    47    50    34     2     9    44    16    27    20    43    28    47    45     7    30    27 
   24    10    44    38    23    30    21    27     5    16    22    18     3    48    18    14    26    46    35    35 
   49    40    32    48    18    26    43     2     1     8     7     3     1     2    30    34     4    13     2    22 
   33    46     6    11    48     9    23     4     9    17    22    20    31     2    47    49    18     2    32    45 
   36    33    17     1     3     8    34     7    33    19    42    35     9    31    16    40    30    28     7    17 
   11    27     4    39    34    31    19     3    18     4    26     7    32    50    10    38    10    33     4    34 
   12    24    15     3    33    28    13    13    18    17    20    36    27    45    17    17     9     7    25    39 
    7    23    13     1    33     3    30    37    37     5    25    34    47     1    26     7    12    12    41    24 
    2    28    16    13    29    13    46    46     7    45    34    24    49    22    49    14     7    17    21    26 
   43    49    25    35    18     3    45    19    12    20    43    29    37    40    37    24    40    40     9     5 
   19    28    46     1    19     1    16    31    33    30    44    43    20    39    48    13    19    19    34    42 
   31    39    41    49    42     7    25    39    18    46    32     7    38     1    20    19     3    10    18    28 
   27    16    29     1     2    25    32    33     9    14    23    34    44    30     7    47    34     3     7    21 
   42    20    22    30     7    23    42     6     3     7    47    42    46    19     4    22    42    20    48     5 
   33    43     9    35    43    45     5     3    44    13    24    25    22     4    15    18     4    47     5    40 
   45    42    28    14    29    38    20     1    35    13    32    19     9    28    38    18    33    31    19    37 


    6    11    12     7     9    10    15    37    33    25    39    24    44    35    17    43    25    34    41    36 
    3    26    25     6    25    18    21    19     7     6    10    45    27    23    39    41    48    36    39    11 
   49    29    13     9    39     7    27     4    10     8    30    39     3    26    33    50    17    47     3    15 
   18    39    27     3     8    30    25     4    43     5    21    11    36    47    25    49    30    31     5    42 
   34     5    39    36    15    15     8     5     9    31    48    31    43    14    46     6    16     8    13    42 
   47    22    24    41    35    20     9    25    19    11    15    19    31    36    15     4    29    49    33    32 
    9    14    18    41     6    14    40    37    40    38     3    42    48    17    35     1    39    10    42     3 
   18    25    12    44    28    39    43    45    28    21    33    23    44    33    21    13    32    43     9    48 
   33     5     7     5    16    12    37     5    41    29    26    45     1    33    14    27    34    41    50    42 
   18    13    47    15     8    43     3    29    29     7    41    34    35    11    31    14    26     1    30    29 
    5     6    13    33    34    13     7     3    35     5    14    22    19    10    40     8    43     7    13    39 
    5    18     7    35    25    42    50    29    21    13    37     7    29    16    31    19    49    22     2    33 
   27    11    29     4     3    17     7     2     3    23    13    28    30    31    45    40     7    21     5    14 
   36    47    49     5    13    10    22    43     9    46    23     1    46    14    14    13    26    29    49    10 
   22     9     7    16     5    11    44    28     4    10    21    11    33    48    12    38    14     1    10    15 
   33    17    33    39    19    49     6    23    32    26    14    39    11    27    20    13    43     3    19    34 
   49    19    31    30    33    47     7     7     9    45    34    48    39     5    25     2    42     3    30    44 
   24    15     7    43    36    10    45     2    34    11    49     1    47    39    43    48    25    18    20    18 
   15    34     9    46    47    47    21    28    29    41    21     4    23    18    37     8    14    16    17    25 
   40    25    47    28    50     6     6    28     8    34    32    10    28    44    48    31    47    10    13    12 


   46    16    50    29    14     3    22    20    27    26    36     5     1    41    38     4    41    30    21     2 
   14    43    49     2    28     7    33    29    35    12    16    17     8     5    22    39    14    16    49    41 
   16    29    29    21    11    22    30     2    47    24     4    50    37    36     6    22    15    15    36     1 
   38     9    44    11    19    32    14    23    23     1    12    47    48    13    18    24    48    32    36    10 
    3     5     7     5     3    39    10    30    40    34    27    16    23    10    10     6    26    14    23    22 
   22    20    31    32    26    10    50    41     1    43    49    14    32    14    13    47     7    16     9    21 
   24    10    34    48    11    39    49    18    42    22    35    44    24    15    20    41    20     6    27     9 
   33    31    35    32     6    43    26    15    20     9    31    19    36    26    17    39    13    10    33    31 
   13    49    47    10     1    43     6     9    36    16    36    32    23     2    21    17    10    45    42     8 
   41    48     7    24    37    32    35    39    14    36    47    23    50    39    46    39    16     1    41    39 
   36    48    22    10    12    44    36     9    19    20    31    20    20    10    11    39    21    23     8    25 
   17    30    32    21    15    13    45    21     8    29    44    46    44    16    49    28    22    31    33    33 
   34    28    41    44    48    15    25    31    26    28    49    23    37    29    45    20    18    25    15    21 
    7    26    36     1    49    21    49    28    18    29     7     5    18    41    34    12    39    17    25    32 
   32    36    21    46    44    45    47    30    43    32    26    32     8    10    40    30    43    39    49     5 
   39     4    31    21    21    44    35    31    24     6     8    33    26    15    24    26    44     5    50    44 
   14    11    10    30    13    11    39    15    43    24    49    20    30     2    34    15     8    35    27    20 
   10    35    10    19    50    47    26    42    47    22     9    21    24    49    50     2    38    16    15    33 
   13    32    34    46     2     3    12    40    37    25    42     2     6    14    33     5    25    45    12    39 
   38    21    18    48    19     4    45    32    14    20    44    32     1     6     1     7    43    49    10    47 


   41    16    43    22    11    43     8     3    21    43     1     9     2    29    22    31    32     9    49    17 
   34    23    35    48     2    27    36    20    18    22    31    40    17    22    24    19    47     3     6    43 
   34    48    17    33    18    43    36     6    32    28    25     6    36    10    26    11    14    32    50     3 
   46    20    39     5    42    27    39    35    50     8    35    17    37    42    38    15    15    16    11    38 
   30     1    47    49     8     1    43    43     1    39    21    48     3    13    17    16    48    30    18    34 
   22     5    33    43    36    50     5    48    32    37    18    13    25    28    29     4    29    49    26    19 
   23    39    19     2    28    42    34    30    45    36     7    41    24     9    21     1    49    36    47    23 
   33    17    22    18    37    46    32    47    47    44    50    25    42    28    22    21    12     8    29     2 
   26    30    17    47    35    20    34    31    36    47    10    37    29    37    43    19    37    27     3     8 
   20    43    33    47    20    31    10    34    45     3    33    21     3    45    50     9     9    27    13     2 
   27    44     3     8    45    17    21     8    10    28     1     7     1    29    43    13    29    48     5    44 
   32    22    44    16    40    27    24    40    46    11    22     4    26    30     6    30    37    20    20     5 
    4    32    31    27    13    10    48     7    31    47    25    20    27    50    28    22    23    14    43    10 
   49    17    16    26    39     6    45     8    21    11    39    17    50    11    29    41    43    40    21    41 
    8    26    15     6    21    25    27     5    32     4    45    41    43    41    23    25     5    48    27    13 
   48    24     8    42    20     6    40    21    25    29    36    25    40    42    40    20    45    19    40    33 
   21    40    25    45     2    41    23     4    24    39    50    35    48    24    27     3    32    26    19    28 
   38    48    39    15    49    29    24    26     6    33    16    17    13    24     2    10    40    42    33    50 
   21    21     8    30     5    23    46    21     8    32    30    48     7    36     6    25    33    19    46    29 
   30    12    16    29    26     1    11     6    19    40    33    49    27    19    23    19     3    16    47     9 


   27    40    38    10    37     6    11    19    20     7    47    48    44    47    10    18    39    43    50     9 
   14    38    33    13    28    21    13     3    32    40    21     6    21    34     9    37    46    42    24    27 
   33    14    31    45    37    18    12    36    13     1    46     3    27    19    13    43    50    27     6    14 
   25    24    46    22    11    21    18    38    11    22    48    34     7    41    13    20    30    49    18    50 
   34    22    20    35     4    16    34     9    27    12     6    18    47     2    18    15    27    13    24    27 
   20    24    20    14    45    20    10    38    36     5    50    12    33    17    32    11    43    11    38    24 
   37    22    44    20    35     7    21    36    16    31     5     3    20     3    47    43     3    30     9    16 
   41    14    44    48    45    47    34    15    24    30     3    31    48     2    30    26    36    30    37     7 
   46    28    24    49    49    13    48     3    33    26    34    26    35    49    36     1    46    11    44    17 
   11    25    25     3    15    40    41    49    37     5    33    38    24    46    24    34    44     1    17    30 
   37    43    39    48    11    26    25     8     6    24    17    13    46     9    44    27    31    13     2    16 
   24    48    11    45    29    21     2    18     6    40    47    12    49     4     5    17     5    12    18     7 
   23     4    34    36    33    14    47    30    24     7    24    49    28    48     5    46    25     6    32     3 
   39     7    20    14    48    42    48    18    49    50    22    44    19    16    17    27    21    41    33    20 
   27    27    12    19    37    39    15    11    43    50    12    50    32    24    48    14    16    34    43    19 
   24    28    36    49    38    39    28    35    34    21    47    14    22    29     1     3    43    41    42    18 
   25     6    36    28     5    25     9    10    22    47    27    26    27     7    14    20    18    33    49    39 
   10    19     6    29    48    24    43     2    45    34    33    23    14    47    29    13    30     4    27    20 
   48     4    18    14    41    38    44    39    26    10    33    49    48     6    31    13    31    15     8    13 
   39    36    12    18    34    45    22    21    25    21    42     7    35    21     8    44    13    44     7    18 


   29    29    27     2    47    46    30    29    13    12    22    33    42    21     5    45    43    19    25    14 
    6    46     6    22    39    42    22    38    47     3    30     2    45    14    15    47    20    44    47    42 
   37    45    18    15    41    20    48    26     7    22    26    28     8    31    39     8     6    23    37    33 
   44    46    42    48    50     7    44    50    50     4     6    21    23     4    39    27    46    49    11    20 
   43    12    15    50    31     3     1    40    30    44    38    28    21    31    39     1    20    23    10    30 
    1    14    21    49    29     2    37    49    19     4     5    42    35    24    31    49    33    18     5    19 
   27     6    33    36    16    50    37    34    40    46     4    45     8    15    38    45    24    45     4    41 
   47     5    45    33    35    35    26    50     1    50    10    25    34    21     9     8    48    38    19    14 
   33    14    27    19    45     5    48    16    39    13    31    15    22    14    35    45    48    36    43    32 
   25     5    12     7    18    21    43    29    20    13    11    31    23     3    40     1    24    14    18    27 
   33    22    27    31    40    15     6    47    49    46    22    12    25     1     9    50    33    44    13    12 
   12     4    49     3    37    19    42    39    39    50    42    10    42    10    13     3    40    45    23    47 
   20    10    42    50    39    12    41    48    17    48     6    19     2    36    44    26     1    41    36    17 
   24    43    27    28    34     4     9    30    43     8    35    15    40    33     5    20    48    46    20    25 
   38    24    17     5    49    33     9    33    47    26     9    37     3    48    13    31    11     1     2    36 
   31    19    15    45    33    38    47    31    25    40    15    13    24     8    28    14    40    50    11    22 
   10    50     7    10    22    18     3    32    16    50    32     1    14    20    37     5    27    16    45    19 
   29     8    40    19    21    11     8    45    47    35     8     5    33     4     4    24     9    13    17    28 
   42    47    22    12     6    39    23     4    28    33     3     5     4    12    47     2    22    41    38    33 
   39    44    30    35     2    45    28     7    44    19    30    41    47     4    24    30    27    27    37    41 


    3    42    22    21    27     1    17    48    19    35    16    44    29    23    35     3     7     4     2    14 
   18    30    11    21    37     5    49    30    14    20    32    10    30    17    44    32    34    41    35    10 
   12    27     3    48    19    33    24    19    20    42    49     7    32    27    44    15    19    21    43    27 
   24     3    43    24     3    30    26    20    30    38    46     9     4    20    35    23    24    13     2    29 
   19     1     5    38    29    24    27    27    50    13    43    11    37    42    36    46     2    45    41     4 
   22    11     1    35    16    50     5    16    35    38    26    22     5    40    40     3     4     1    17     1 
   15    10    46    15     5     8    38    29     6    26    19    10    50    14     8    48    27    41    47    49 
   28     9     7    42    48     5    22    50    21    16    26    34    30    43    18    42    28     8    48    10 
   45    18    11    27     8    39    36     9     3    21    46    25    31    15    22    35     8    43    10    43 
   14    41     1    23     6    33    35    14    27    46    22    20    29    17    34    48    13    46     7    12 
   34    17    30     5    23    24    14    26    32    36    33     6    22    41    40    34    29    49    21    44 
   46    18    25     9     2    32    34     7    14    45     4    13    33    31    10    26    38    24    45     5 
   48    46     3    13    21     4    31     6    15    14     2     9    37    40    26    10    40     4    38    25 
   39     9    50     3    48    31     7    50    25    15    19     1    43    42    25    25     7    33    35    29 
    4    12     1    33     2    13    13    23     4    47    36    31     4    13    45    10    18     1     6     4 
   36    16    48    31    21    19    36     4     7    49    35    35    44    15    12    12    27    32    11    24 
   44    41    18    32    27    22    36    45    11    26    37    29    28    30    13    43    44    34    37    48 
   38    13    14    29    31    16     1    13    38    11    10    32     3    10    15     6    11    41    47    29 
   19    10    30     5     3    33    20    30     5    22    24    28    32    20    10    11    19    15     5    43 
    4    27     2    25    37    45    39    13    38    47     2    32    26    20    13    50    35    20    44    29 


   30     1    45    35    27    13     5    11    24    44    50    25    21    31    31    26    14     8    47    10 
   37    50    29    39    45    50     4    11    14    47     3    41    44    13    43    17    34    43    36    22 
   29     4    27    15    26    44     4    50    42     9    43    23    30    23    11    24    40    50    41    10 
   41    11     9    47    26    42    24     6    24    44     6    39    23    39    13    21    43    44     2     1 
   39     9    50    46    37     8    23    15    13    32    23    20    23    24    41    27    31    25    48    31 
   31     5    23    46    36     9    39    33    15    46    31    35    49    26    10     8    12     2    44    35 
   34    12    20    20     2    43    47    24    21    32    46     6    43    15     4    32    26    22    10     3 
    4    31    19    50    40    43    48    46    16    35    26    23     2    11    41    34     5    46    11    18 
   48     3    15     1    22    30     9     1    16    36    28     4    40     8    10    28    36    11    33    30 
   46    47    29    28    18    35    39    33    35    29    39    22    19     8    33    14     6     9    50    16 
    5    14     9     9     9    44     5    31    16    37     2    11    21    10    17    22    29    27    20     4 
   14    44    45    28    19    15    46     2    40    21    13    46    31    42    34    43    42    34    41    10 
   47    10     8    30    49    15    28    31    24    19    13    34    50    17    31    37     4    48    25     6 
    6    10    34    22    25    40    30    37    46     7     7     3    39    30    38    28     1    42     5     2 
   32    40    37    18    45     8    48    18     9    27    45    49    23     7     4    40     2    13    35    19 
    5     3    26    44    43     8     1    42     1    10     2    47    34    44     7    22     9    40    32    23 
   23    41     6    39    31    22    19    46    48     9    48    41    12    23    19    16    23    34    44    41 
   42    43    49    29     4    16    17     7    14    33     3    31     1     4    17    11     1     7    45    25 
    1    46     2     9    32    27    50    50    14    40    33    12    17    36     7    28    15    15    15    38 
    4    34    18     7    22    33    16    24     4    49    22    47    13    42    38    26    42    35     4    48 


