   17    15     2    15     0     8     6     6    17    12     3    17    19     0     6    14     7    22    19 
   23    24     0     3    19     9    19    15    20    14     5     3    23    13     0     2    19     5    19 
   23    10    13    24    20    17     0    16     8     2     4    22     3    19    11     9     1    24    14 
   16    25    25     0    17     8    16    20    12    20    24     1    12    11    19     1    25    25    21 
    0     5    12    12    21     6    24     5     7    14    20    19     8    23    18    11    13    14     2 
   21     3     6     1    11     5    18     0     9     0    19     9    19    16    15     8    18     9     0 
   22     5     9    25    24     2     2    17    11     1    22    17    20     4    15    25    19    22    23 
   25     2    11    20    19     0    25    25    13     4     5     2     3     3     2    16    24    10     7 
    9    14    16    21    12    13    11     6    21    22    23     4    12    21    18    12     7    10     6 
   12    12     9    13    20     0     0     3    11     8     3    11    15    25    23    14    20     2    17 
   20    10    18     6    22     6    22    15    22    25    22     2    20     8    12     5     6    24    12 
    4     0    23    12     7    10     2    20    12     7    19    19     2    22    22    19    20     4     9 
   19    19     4     9     1     5    14    25     1    19    18    21    18     5    13    22    16     0     9 
    1     9    17    18    17    17    22     4     8    18    25     8    14    10     4    24    19     0    14 
    2    25     0     2    16    19    24    18    18    13    15    20     9    16     4     1    16    18    16 
   17    16    14     6    24    22     3    20    11    12    14    17     3    21    22    19    10     2    21 
    0     5    16     2    15    19    25    25    14    16    13    11    12     4     2    22    22    22    20 
    5    11     3     1     7     1    19    15    18    21     4    25     9     9     0    20    15    11     0 
   17     9     5     1     7    18    14    23    14    24    19     4    18     8    19     7     8     9    24 


   24    18     9    10    23     0    16     2     7     7     7    22     0    25    14    16    22    16    12 
   21    16    20    19     6     5    25    15    18    10     2    18    22    15    24    15    21     6    20 
    3     6    14    14     4    11     9    11     6    14    20    23     1    15     6     4    10    20    22 
   23     5    19     0     2    21    12    15    10    19     8    20    11    11     9    10    25    22     3 
    6     6    19    25    21     0    24    20    12     9     7    22    12     3     4     4    12    11    13 
   14     4    10     9     1     7    16     9    13    22    22    11    21    25     8    23     5    23    25 
   12     5    15     9    15    20    15    20    15    14     6     2    11    21     5     9     3     3    11 
   22    20    13    13    21    16     8    18     7    23     8    21    11     5    24     6     1    22     3 
   19    22     9     3     8     2     5    10    24    25    22     6    12     9    14    20     1     9    13 
   18    20    16     2    23     0     9    16     2    11     4     9     0     7    18     5     0    20    13 
   21     9    23    18     7    10     0    17    18    18    18    21    13     7    13    20    19    18    10 
    3    10    11    20    21    18    20    25     0     2    16     3    10     9     6     6     7    16    21 
   14    23    24    16     3    13    18     2    24     9    16    14    15     9    16    13    20    10    11 
   13    12     6     1    22     4     3     0     7     3    10    22    15     9     6     4    21     1     6 
   14    16    13     6    13    17     9    25    13     7     5    18    19    19    21    14    24    19    17 
   19    23     6    15     2    20    15    13     9    16     4    11    14     1     2    22    17     1    11 
   20    10    23    22     9    12    12     4    20    16    13     3     6    10    16    18    17     7    16 
    9    18    14     4     1     4     6    25    19     5    18     9    21     3     9    25    21    19     4 
   23    13    19    17    11     2    15    25    15     3    24    21    10    11    16    15    15    12     0 


   16    14    11     3    24     1    21    22    24    13    21    22     6    22    20     2    19    14     0 
   11    23    18    18    21    25    25    16    13     5     6     0     3     7    25    10    17     4    24 
   24     6    21    18     0     4    24     6     1    18    25     3    23    23    10    10    14    16     5 
   14     7    20     3    12     2    12    14    12     5    12     6     1    11    25     9     7    20    15 
   13    19    14     8    20     9     3    25    25    16    22    22     5     7     2    10    24     2    17 
   13     7     7     9     2     8    16     1     9    13    25    10     0     0    24     0    16    17    13 
    3    20    25     2    19    14     4     7    16     0    18     2     2     4    17     9    18     3     5 
   25    12    15     4     0    19     7     1     0    19     5     6    16     3    18     4    15    15    24 
    9    11     2     6     8    16    19    13     6     4    10     1    22     4    24    21     5    24     0 
   23     1     3    19     3     7     7    10     5    19     5    11    24    16    11    19    14    16     5 
   25    22     0    17    15    12    20    19    14    14     9    24    19    18    22    13    17     0    25 
    8    25    16    25    14     2     9    15    19     7    11    11     4    11    17    11     3    24    20 
    9    19     4    22    20    19    22     7     4    13     9    10    11     1    17     1    14    15     7 
    4    15     3    23    24    20    11     4    24    23    20    12    20    17     3     9     1     3     8 
    7    12    21    17    11    23     6     5    12    21     6    19    15     8     1    20    15     0    17 
   14    21     8    14    16    25    24    11    21     0    15    22    13     6     4     0    20    14    15 
   14    13     9     2    23    21    22     0    17    11    12    12    22    25    22     4    15    23     8 
    2    12     3    21     1     5    25     8    11    15    23     0    21     6    16     9    25     9     3 
    6    14     3     8     0    20    23    22     2    14    17     8    15    14    14    15    16     4    19 


    6    13    11     3    15     8    15    25    13    17     9     2     5     9    11    20    17     1     6 
    5    20     4    22    11    21     4    23    17    12    21     0    12    23    17    19     7    21    15 
   21    23     5     1     7    10     8     9    21    12     1     6     7    17    22     6    11    25    13 
    6    25    21    20     2     9     3     5    18    20     0     1    20    25    17    25    20    13    19 
   19    16    11     8    22    14    21     5    25    16    14    19    14     4     0    20    11    19    15 
   18    23    14    25    22    12     6     2    13    13     9     1    21    15    10    24    18    20     0 
    1    22     3    16     4     8    12     0    10    15    20     7    11     8     1     4    11    17    18 
   18    23    18    24    25     4    21    20     5    19     7    22    11    15     9     2     7    13    25 
    8     6    23    15    19    25    23     5     3     0    20     9     7    16    16     2    18     5    22 
   25     3    22     0    13    20    21    12    14     4     1    12    24     4     1     5    18    25     1 
    3    11    13    19    16    19    20    19    16     9     2    18    14     7    20     2    16     8    13 
    1    25     3    13    16    18     0     7    13    16    16    18     8    24    22    25     2    22    24 
   17     5    14    13    22    19    25     2     5     5    22    12    24    21    17     2    11    14    14 
    2    11     4     5     2     0    18    15     7    23     8     9    15     5    10    13    23    22    19 
   11    14     6     9    16     7    24    11    20    19    24     3     8    21    12     6    21     8    18 
    7     4     7     2     6     6    15    21     6    14     9     4    11    23     3    11     4     1     5 
   24     5    14     2    11     7     1    13    15    20    22    19    15    12    10    23     9    12     9 
    6     6    19     1    14     0    18     6    13    11    22     7     1    19    19     3     0    16    18 
    2    18     3    18     1    12     5     1    13    11    11    22     7    23     3    25     8     8     8 


   11     8     6    10     1     3     5    21     5     9     9     6    17    13    20    14    22    22     0 
    7    10    13     2    14    24    10     8    19     5     1    15    16     2     3    13    22    20    25 
   22    17     8    13    16    23    23     2     5    10    25    10    20     7    19    20     1    20    10 
    2     0     0    10     7     1    15     6    24    16     3    10     4     4    12    25    23    15    25 
   11    16    22     6     2    13    17     5     2     2    21    25     8     5    20     4     4     1    19 
   20     8     0     1    22    14    17    24     9     8     1    16     9    24    20     0    21    11    17 
    6     7    22    12    13     1     5    16     2     9    15    24    24    18     0     3     1    16     8 
   20    16     9     0     7    20    15     6     8     1     4    21    24    21    24     4    25    14    25 
   24    17     0    16    11    21    25     3    14    13    20     9    24    16     3    24    10     9    10 
   19     5    17    21     9     5    13    24     7    15    22     4     8    12    21    11     3    19    14 
    6     2     3    18     5    15     4    21     2    20    23    12    20    17    11    22    14    22    17 
   25    13    17    14    23    20     9    16    10     9    21    19    13    22     5    25     3    11    12 
   22    21     6    16     4    21    10    17     6     3     7    20    18     3     8    14     3    10    19 
   20     1    21    23     7     9     5    10     7    24     1     9     2     4     1    12    25    10     6 
   21     9    24    13    15    13    10    10     0    18    17    25     2    23    15    16    17    13    21 
   23     3    19     0    11    25    20     4    12    25     2    23     2     7    20     4    23     1     4 
    1    17     2    19     6    22    21     7    10    21     3    12    11     8    22    19     8     6     4 
    0    13    21    12     9    12     9     7    16    22    20    19     3    12    14    21    25    13     1 
   21     5     2    11     7    19    16    14     9    22    25    16     5     7    24     5    16    15    13 


    0    10     7    22    16     9     2    12    11    24     2     0    19     0    17    12     0    20    15 
    8    23     0     6    15     3    17     4    13     8     7     0    13    14    14    17    22    24    13 
   18    23    22    14    24     3     1    11    18    15     1    12    15    14    12     4     5    17    17 
   16    14    18    13     9     2    25    22    12     6     0    22    24    25    21     9    20    25    19 
    0     5    15     2    18    21    11     6    17     6    16    12     7    12    11    12    18    22    24 
   13    15    20     0     4     4    11    15    19     5    25    14    11     4    16    12    14    14    24 
    7    20    11    19     2    15    11     9     2    19    23     7    21     5    22    25    23    14     2 
   18     0     8    23    18     9     6    19     7    25     0    13     0     7    12    22     5    24    17 
   23     0    17    23    15    21    15     8     7    16    18     0     2    13     4     3    20     6    20 
   15     4    21    17    11     2    13     4    15    13    14    24    23     0     6    17     9    19    24 
   10     1    21    19     8    13    15    10    21    22     2    13     3    12    12     3     3    21     8 
   14    10    19     6    12    10    23     4     8    13    23    23    22     7     3    22    18    24     5 
    3     8    22    18     9    13    13    24    17     4    10     5    18     8    14    17    14    20     5 
   14    13    15     9    10    23     1     6     8     4     6    19     0     1    13    18    25    13     7 
   21     2     5     4     9    15    24     8     0     4    17     2     2    13    15    11     9     1     1 
   24     4     9    10     3     3    23     4     3    19    23    15    25    20    15     2    11    21     8 
   12    25     3    23    25     4     3    24     5    20    25     0    10    11    22     3    12     3     7 
    8     4     9     0    21    11     1    18     1    10     2    13    18    21     0    17    16     0    10 
   19    22     9    22    20    14    10     5    17    20     5     2     5     2    13    23    10    17    12 


    3    10    14    18     6     7     8    18    16    20     5    15    19    21     9     8    14     2    18 
   17    10     3    18     6     9    14    20     3     5     8     5     6    22     5    22    18    16     3 
   20     0     7    23    11     0     9    25    17    21    20    18     1    23    19     8    24     6    12 
   23    17    16    24     3    17    12    17    23     7    25    15    15    24     0     6     4    12    19 
    2     5    23     0    10     2     8    14    14     7     7    16    19     0    10     0    12    21    16 
    8    23    14    12     4     8    22    24     7    15    23     6    19    11     2    13     4    21     1 
   11    19    12     1    21    23    22    23    21    10    24    24    25    23    22    22    18     2     2 
   20     9    13     3    25    15     0    19    14     6    17     2    10    20    15    11    14    21    13 
   23    20     4     4    21     1    15    18    19    25    24    19    12     3    21    18    20     6    13 
   21    13    14    24     0     2    20    12     5    13     0    21    23     2    13     0    19    21    21 
   16    12     5     7     6    20    16    15    17    10     5    15     8     1    20    14    21    23    17 
    5     8     9    19    19    21    24    22    15    19     3    25    16    12     2    14     6    13     8 
   15     3    17     3     4    24    21     4    11     0     7    11     0     3     7    22     1     1    10 
   24    23    16    18     3    20     8    15    17     7     8    12    19     4    15     3    12    18    21 
   15    13    15     2    19     9     1    13     8    24    13     3    20    15    10     7    24    23    23 
    9    12    22    19    10    20     9    20     6    18    15    11    11    15    24     8     7    25     7 
    3    18    18    15     8     6    25    14    10    13     3     4    14     7    13    13     5    14    12 
   16    18    12     2    22    19     9     4     1    11    17    24     9     7    24    16     0    22     9 
   11    19    12     4    25     3    11     8     5    12     1    24    24    23    23     9     9     5    19 


   12    20    13     7    24    22     8    10     0    13    15    24    18    21    12    23    14    18     4 
    6    19    25    17     0    19     3    12    17    18    14     3    25    15    17    14    22    23    18 
    4    10    11     5     8    20     0     3    23     4     5    15     0     6    16    18     6     6    16 
   22     6     7     8    17    20    11    23     8     5    12    12     1    11    20    23    12     6    14 
    7    24    11    20    21     8    10    13    21    12     3    14     7     2    11     1    24     2    17 
   25    21    15     4     5     2    17     4     2    23    10     2    14    24     9     7     4    12    25 
   19     9    13    20     3    14    16     3     6    14    17     9     5     1    18    11     4     4     2 
    6    21    21    21    18    10     1    22    20     1     2     4    19    10     3     3    20     5    20 
   18    11     8     5     3    20    21    22     5     1     4    23    25    11     1    24     9    19    24 
   21     2     6    17    15    22     6    19     8    15    14    24     6    17     8     0    11     8    25 
   14     1     3    24    19     2     3     3     2    15     0     4    18    10    10     3     5    17     0 
   13     6    11    23    22     3    25    23     7     7    12    16    11    17    22    24    11     8    19 
   15    24    16     2    22    18    24    10    20     6    23    20    10    12    13    22    22    23    19 
    3    19     5    14    14     6    10    13    21     4    10     6    17    17     7     0     8    13     2 
   19    10     8     4    15    11    24    17     2    24    19     3    14     9     1     8    13    25     2 
    3    21    13    12     9     0     3    16    17     4    19     3     4     5    25    16    14    21    25 
   15    13     6     0     3     3    18    22    23     2     5    23    20     1     2    11    24    21     0 
   14    23     1    11     3     8    11    16    21    22     3    19    10    18    12     9     0     7     4 
   11     8    19    10    14     5     4    16    17    23    20     5     4     7    22    15    22    21    13 


