   20    24     1    50    49    33    22     2    36    42     6    21    37    34    35    38    32     9    14 
    1    18    15    42    45    25     1    47    29    48    50    36    17     5    20     3    49     4    26 
    6    12    47     5     1    43    35    47    39     4    39    43    39    22    49    47     1    36    31 
   33     8    33    27    40    15    50    10    10    24    32    34    28    27    49    22    26    20    33 
    1     6    26    20    25    29    28    45    13    43    11    16    38     2    42    41    40    12    34 
   36    42     9    41    11    46    33    36    36    39    41    47    42    43     6    31     2    26    11 
   22    33     7    15    20    38    27     4    43    17    45    21     5    27     8    48    19    19     7 
    5    31    25     2    28     5    42    15    42    15    42    40    43    29     1     6    11    38     8 
   24    31     6     3    18    38    29    23    45     8    33    28    28     7    22    44    24     2    42 
   37    26    41     6     6    37     2     8    14     7    33    29    27     3    23    24    40    50     6 
   21    27    32    17    31    18    10    39    41    43    50     9    18    11    39     3     2    50     1 
   15    27    30    50    50    16    11    37     4    30    13    17    28     2    48    12    16     2    14 
    8     8     9    11    33    38    43    26    44    26    48    33    19    21    35     3    18    26    37 
   48    31     4    26    15    28    14    26    20    25    40    34    43    33    24    39    42     9    19 
   24    39     7    25    19     4    31    21    17    47    16    38    43     4    39    18    29     9     2 
   49     8    47    21    50    15    28    10    38    21    12     1     1    43    14    18    15    35    49 
   33     9    21    45    10    29    27    41     6    50    14    27    26     1    17    12    33    14    45 
   37    49    12    37    20     6    38    13    15     8    27    41    30    30    19    10    23    22     3 
   47    27    13    36     5    33    44    25    30    43    27    44    22    23    32     1    11    47    26 


   12    16    33    24     9    34    11    10    34    33    26    29     8    13     1    26     3    37    18 
   37    44    27     5     2    47    38    31    14    29    11     3     9    23    35    24     1    41    30 
   27     1    10    48     3     8    42    22    16    37    26    14    11    16    19    26    12    28    24 
   39    23     9    26    35    20    33    46    34    13    42     6    24    11    47    35     7    19    10 
   37    20     2    16    17    40    31    13    22    40    47     3    30    49    45    35    10    47     7 
   42    12    25    48    36    30    41    21    49    26    10    30    40    42    38    13     4    17    24 
   18     7    47    45    23    23     5    18    49    31    35    40     8     6     1    29    22    44    14 
   30    22    38    46    11    26    34    45    27    20    25    18    30    39    41    50    40    25    28 
   20     6    13    19     2    44    16    42    28    29    17    37     5    15    36     1     3    21    28 
   10    41     9    42    14    45    27    10    22    47     6    29    31    29    40    35    19     3    48 
   38    34    49    37    11    11    36    35    29     9    44    42    42    31    39    22    23    12    15 
   13    36    44    14    41    43    18    32    50     9    14    33    17     2    11    27    19    16    11 
   13    48    30     6    35    38    39    15    12    36    35     6    40    40     1    20    27     5    36 
   31     1     5    41    10     3     7    15     2     5     6    50     8     4    25     2    34    32    29 
   20    11    16    24    20    35    17    25    18    50    16    18    34    39    27    23    36    20    33 
   23    33    39    13    21    34    28    28     2     8    45    47     2    32    48    44    29     4     4 
   48    30    47    12    48    29    29    28    44    33    30     5    35    39    20    13     4     3    25 
   15    40    15    31    11    19    38     6    47    21    49    38    14    30    34    48    37    49    23 
   49    43    18     7    36    47    24    45     1    40     5    37    32     2     2    40    29    39    45 


   44    16    43    46    19    15    48    15     6    38     2    42    38    26    17    44    50    47    46 
   23     1    21    40    18    32    22     2    26    32    26    45    28     2    38    42    42    33    34 
    6    12     9    17    24    12     7    48    17    14    46    50    37    46    34    24    17     5    40 
   25    41    30    42    20    42    28     3    39     5     5    49    13    20    13    29     4     1    50 
   42    18    48    50    29    43    34    13     2     1    13    37    46     4    14     2     9    20    15 
   35    47    19    16    41     6    33    20    13    50    37    39    21    26    36    27    29    38    25 
   24    21    39     3    26    38    15    49    24     7     8    32    31    47     1    23    19    14    36 
   49     9    49    41     6    22    32    21    50     9    14    21    13     6     9    20    18    24    23 
   43    34    49    11    35    28    38    26    45    43    36    39    47    47     5    22    17    44    31 
   43    44    46    48    43    17    12    49    12    23    24    26    44    21    48    11    24    46    15 
   40    50    28     1    48    14    16    20    50    21    27    12    23     2    24    15    13     3     5 
   49    16    28    42    47    17    46    25     5     1    42     5    25     7    34    14    44    37     5 
    2    36    18     5    22     6    48    24    23    16    49    12    33    35    30    24     2    15    35 
   21    29    48     7    48    12    15    50    19    24    26     5     2     2     6    40    10    19    28 
   44     9    28     7     2    12    43    48    35    10    21    26    13    40    45    39    33     2     8 
   23    36    40    45    49    30    26    44    14    19    26    33    11    41     5    13    50    33    16 
   20    39    31    27    37    14    14    25     5    46    44    33    20    47    18     3    35    13    26 
   32    23    21     3    41    32    14    19    30    12    10    12    18    28    35    10    45    26     1 
   20    23    20    19    31     3    29     6    41    27    36     8     9    22     1    42    17    17    18 


   31     4    50    49    12     4    34    18    28    49    25    49    28     4    14    43    19     2    39 
   27    10    10    12    31    31     6     6    48    20    17    41    44    20    17     8     9    34    28 
   50    27    24    17    17    38    48    11    34    29     5    29    23    24    39    34     4    39    14 
   24    20    50    17    35     9    23    28    38    13    12    15    37    19    19    21    46     8    46 
   30    45    33    28    29    12    23    39    37    41    12     7    16    31    23    42    33    31    11 
   21    30    39    10    39    12    31    41    48     5     5    29    46    21    22    41    31     7    26 
   45    42    10    37    17    34    13    23    14    35    43    23    17    13    48    47    28    11    10 
   17    24    34    23    24    16    10    30    32    48    49    20    38     3     3    48    37     2    30 
   41    48    22     4    11    10    46     9     2    47    13    45     1    17    35    48     5    37    24 
   37    44    26    43    11    37    22     5    12    33     6     7     3    11    48     6    25     8    47 
    3    24     9     4    26    22     8    39    44     5    29    15    45    40    19    19    43    24    48 
   50    10    38    40    41    30    47    45     3    13    44    39     1    32    21    14    26    21    22 
   44    40    22    12    45    45    40    47     2    33    49    19    24    21    44    28    50    18    13 
   31    37    29    19    46    40    39    18    17     6     7     8    26    33    45    26     3     5    14 
   30    34     8    45    25    46    24    31    36    42    33    44    27    25    40    46    26    20    19 
   26    40     4    16    20    26    34    18    35    27    50    24    50    25    16    18    46    18    34 
    6    28    34    45    49    38    14     5    40     8    18     3     9    11    34    43    24    19    39 
   36    15    50     7     2    50     4    26    23    14    14     4     2    23    39    12    38    47     5 
   28    19    26     6    37    10     9     7    26    23    33    42     6    17    14    36    26     5    38 


    4    11    32    19    14    44     9    25    41    45     1    39    24    23    46    17    13    23    20 
   32    29    15    21    14    46    15     8     1    19    47    35    50    10    26    46    24     7     1 
    2    39    20    14    25    11    49    31    29    45    12     7    16    47    44    27    32    38    31 
   17    11    50    13    38    26     9     8    13    40    19    40    21     8    42    46    29    21    25 
   11    34     1     2    42    22    43    31    47    19    19    28    16    38    35    32    36    28    36 
   30    17    43    20    15     8    25     6    32    37    44    13    28    44     7     3     6    28    46 
   19    18    29    43    20    25     5    30    16    38    44    33    38    22    48    10    47    29    30 
   16    19    35     1    44    10     6    45    50    17    12    40     8    35    28    14    30    39    43 
   24    38    11    31     4    19    15    19    36     6    49     3    21    43    47    47    14    37    19 
   34    47     7    42    15    38    13     6    39    22     4    15     4     3    10    22    42    22    44 
    1    11    21     9    42     7    46    10    31    48     3    22    50    20    37    40     4    21    27 
   46    24     5     1    17     8    25    36    12    12    11    49    18    22    21    38    25    38    39 
    5    28    25    17    17    39    27    30    44    31    13    38    30    18     4    22    50    33    17 
   48     1    28    18     3    16    50    21    22     7    49    16    47    47    46    31     4    19    45 
   15    50     2    50    11    26    38    13    18    47    27    26    49    12    35    36    19    24     5 
    1    43    20    21    16    42    22    26    19    21    21    34     7    50    42     5    13    10     8 
   13    18    49    34    19     6    28     5    28     1    11    17    32    50    11     4    35    49    44 
   38    14     1    46     9    34    11    48    45    33     2    27    46    35    12    28    24     5    42 
   16    17    45    23     1    50    40    50    20    36    21     2     1    39     5    50    19    35    22 


   24     9    42    24     5    45     1    18    19    19    40    44    14    28    46    39    34    28     7 
   22    37    31    17    11    33     1    48    31    49    21    18     2    30    34    35    34    20    45 
   50    48     9    43    11    45    42    35    10     7    21    22    36    48    22    38     3    25    38 
   25    12    15    37    26    39    31    45    21    11    19    46    47    42    37    49    12    21    47 
   32    27    37    28    32    39    11    16    10    39    45    41    12    35    33    17    48    13    30 
   29     5    12    31    30    14    37     9    44    41    40     5    50    28    47    35    31     3    21 
   13    36     2     2    13    17    40    36    24     4    26    50    24    43    43    40    35    16    16 
   27    33    46    20    47    38     9    18    48     4    50    11    20    33    29    42    20    26    45 
   41    14    14    11     5    24    32    39    29    15    42     5    10     5    18    18    18    37    42 
   40    14     5    19     5    26     5    28    42    35     5    11    50    44    28     9    21    42    34 
    8    43    41    26     4    18    36    10    33    21    49    11    18    38    35    49    14    38     4 
   18     7    31     6    43    33    15    12    24    27    13    37    21     2    49    23    29    15     5 
   10    20    27    41    11    36    27    42    40    25    18     6    42    19    28    48    27    33    35 
    8    36    45    35     5    37    21    18     7    41    19    42     5     2    27    14     1    11    31 
   34    13    22    29    16    43    32    12    25     2    27     9    11    10    27    23    22    20    24 
   41    31    15    41    49    31    17    29    17    30    19    50     3    41    18    21    13    40    40 
   15     4    24    26    17    22    16    30    50    15    10    12    27    30    33    35    28    18    47 
   37    50    29    12    40     8    14    50    37    25    29     2    48    44    46    45    45     3     3 
   31     1    21    15    12    24     8    43    46    42    25    23    15    23    14     2    16    36    25 


   24    45    12    40    14    39    41    43    11    48    21    24    15     9    12    31    39    41    25 
    3    33    25    14    16    11    40    20    40    38    38     9     2    11    12    18    24    20    28 
   11    28    12    15    16     5    35    15    39    22     7    50    17    16    45    10     5    14    17 
   16     8    40    39    14    10    37     5    23    15     5    26    32    41    29     1    14    15    26 
   37    38    44    36    49     1    24    35    21     2    44     1    26     2    22    18    35    32    17 
    1    48    17    11     5    34    27    48     2    42     4    47    35    11    47    46    29    36    32 
   20    16    17    35    28    40    48     9     3    16    19    28    47    16    44    45    44    14    24 
   31     8    30    15    33     9    44     8    45    43    39    30    17    28    23    47    12    10    30 
   19    11    35    38    20    14    37    48     4    20    43     4     1    18    18    28    38    11    46 
   30     8    21    32    24    34    44     8    14    28    15    22    48    21    50     4     3    46    37 
   41    34    11    20    14    47    20    13    45    17    15    34    26    46     5    21     7    39     9 
    5     7     7    49    13    49    49    19    25    13    35    21    24    47    27    46    37     3    13 
    9    24    41    43    13    34    33    27    43    36    33    29    39    48    17     9     8    18    31 
    5    35    22    19    42    41    46    29     5    21    25     8     6     8    18     1    41    48    10 
   23    45    30    13    40    19    16    43     1    35    15     7    32    14    42     2    18     2     9 
   26    10    46     2    48     3    19    42    50    17    33    34    16    17     3     6    12    26     6 
   49    37    26    12    17    16    38    28     4    20    37    25    23    30    48    13    20    14    42 
   48    10     6     7    49    40    11    38    20    28     4    38    44    47    13     9    27    24    22 
   40     8     8    48    31    45    40    35    29    42     7    12    12    47    18    19    17     1    39 


   16    37    32    22    24    33    41    20    17    48     6    32    42    18    30    23    37     8    22 
   18    32    26    11    20    15     8    36     2     7    49    46    35    11    12    17    49    47    50 
   25    38    40    37    21    30    16    20    17    37     5    41    11    35    45    14    30    21    36 
   25    31    35    25    44    43    20     6    16    31     5    31     2    33    30    28    31    19    44 
    2    12    48    50    37    23    50    48    34    50    15     9    48    46    40    48     5    22    49 
   43    42    13    41    39    31    25     5    28     8    38     8     2    35    33     5     6     8    31 
   32     5    17    41    33     3    13     2    23    10    30    44    24    24     2     9    30     5    43 
   12    15    29     2     8    25     1    16     5    38    19    50    38    33    33    24    46    11    42 
   42    22    17    15    50     5    28    14    24    21    44    13    43    16    35    29    28    16    26 
   49     5    25    50    16    38    41    22    47    47    16    50     4    17    36    46    33    26    41 
   20    47    48    32    30    41    16     3    18    24     1    49     1    25    44    44    21    49    48 
    1    10    38    25    20    33     2    35    49    36    17    47    50    13    43     7    23     2    46 
   39    37    45    22    12    35    22    30    24    24    22    19    11    17    18    29    21    17    19 
   11    37    17    20    49     4     7    41    11    31    19    26    25    23    39    39     1    22    25 
   12    31    29    17    31    12    48    38    25    43    13    12    25    23     8    28     6    23    26 
    4     2    27    24    42    14     5    18    45    22    34    25    37    11    26    36    24     6    41 
   22    14    47    15    21     9     8    41     3    49    45    11    24     9    23    47    28     3     7 
   37     6     5    33    47    14    46    13    12    31    25    34    13    19    19    38    13    47     5 
   29    41    26    29    32    31    47    32    18     2    21    42    49    27    20     5    12     1    11 


