    4    16     8    18    17     3    17    20    22     8     5    10     0    24    12    17     3     1     0 
   23     9    16    19    18    20     4     9    25    25    25    13     1     6    11    19    11    18     0 
   14     4     6    24     2    21    17    23    16    10    17     3     9    23    19    17    16     8     1 
   25    17    21    25    22    13    12    24    11    23     3    18    10    12     5    15    18    12     9 
   10     4    22    12    21     7     1    12    16     1    11    19     6     0     4     1     5    24    23 
   17    23    17    15    15     1    14    11    25    12    16     5     4    25    16    14    12    22     2 
   24     7     0    19     9    22     9     5    10    22    15     0    22     8    24    13     7    15     3 
   12     6    24    17     8    19    15     0     3     9     6     1    25    10    17    10    19    13    13 
    5    21     8    15    18    14    20    19    17    13    12    15     7    22    17    12    13    24     1 
    1    20    23    22     5    25    17    22     5    23    11     4    23    12    22     5    10     1     6 
   16    19     1    20     8     6     8     7     1     3    10    11    21    22    18     5     2    15     1 
    0     4    23     1    14    23     5    24     4     8    13     8    14     8    18    23    10    21     8 
   12    13    11     9    18    11     4    12    19    13     4    21    15     0     5    14    21     6    13 
   22    11     7    13    20     9     2     5    16    11    20    20    20     1     7    11     5    17    19 
   17    20    13    17     2     8     5    25     5    24    19    24    20     5    14     7     3    17    17 
   14    16    10     3    21     9     0    12    25    17    10    21     9    19     2    22    21    15    23 
   18     1     1    13     7    10     4     2    18    10    13     2    15     9    24     6    24     6    17 
    3     3     0     4     0     9     6     6    13    18    24     1    15    11     1    10     9    20    12 
   21    12     1    24    22     6     9    19     4    20    24    22     5    10     3     5    25     6    11 


    8    25    16    14    15     4    11     6     4    18     9    17     2    14     2    20     0     5    20 
   17    11     5     7    12    13     7    23     5     1    23     0     9    11    18     1     5    15    11 
   10    11     7     3     1     1    22     0    13    21     5    17    22     0     7     8     5    24     7 
   21    22    25     0    10    24     2     3    17    24    20    14     7    23     0     7    22     0     4 
   11     7    11     1     4    16    24    24    20    22    17    16     7    16     9    23    13    23     9 
   17    23    20    14    10    16    11     9    23    24    19    24    18     4    18     6    10    10     1 
   21     8    19     9    21    21    20     5     8     2    23     4     9    11     5    18    10     1     8 
   23    19    12     1    10    15     3     3     2     6     0     2    19     6     8    24    23    10    21 
   20    23     8    19     5    13    10     1     2    24     2    24    10    25     3     2    21     8    10 
   17    19    20     3    19    21     9    14     1    11     9     6     7     7    23    20     5    24    17 
   17     4    10    15     4    23     6    12    21    17    20    14     1    23     2    22    20     8    10 
    4     8     3     0     0    21    13     0    24     0     5    14    17     4     6    22    15    15    20 
    7    14    24    17    13     0    22    18    14    16    15    22     6     6    24    25     6     6    22 
    0    19    21     6    24     9     1     7     8     7     2    10     3     3     3    16    22     8    13 
    7     2    14    22     4    15    12     9    19    18     3    12    18    19     6    15     9     0     6 
   20    19     4    14    19    14    18    19     2    15    15     6    11     0     9     9     8    13    13 
   20     8     9     3    15    16     8    13    22    10     9    17    25    13    24    16    14    13    17 
   13    17     4     8     8    10    20     5    22     9    16    10     1     4    14    12    14    22     8 
    3    10     8    19    25     3    18    12    22     9     3    15    11    24    10    16    22    19    10 


   15    25     1    11    18    13     8    23    18    18    23    15    25    10     4    13    20    14    21 
   13    10     6    20    22    18    16     4     0    17     5    19     6    19    25     8    18    15    16 
   14    20    16    25    15    24    17    21     1    16    25     7    15    22     4     4    22    12    18 
   12     9    14     7     1    19     0    15     2    11    15     1    22    23     2    15     0    25     3 
   17    11     6    21    20    11    25    22    19    20    10     7     0     2    14     3    10     4    10 
   11    24    25    19    16    10    17    12    23    19     2    23    20    12    13     0     0    25     4 
   18     7    12    23     5    15     3    11    25    19    18     0    25    21    25    18    25    19     8 
    2     0    25    21     9     4     3    17     5    21    13    12     7    14    18    15     2    14    24 
   15     6    13    19     7     2    21    12    17     2    23    20    11     0     5    18    14    18     5 
   11    16    19    16     7    24    11    10     5    18    22     3    13    14     0    11    16     1     2 
   12     6    19     8    20    12     4     8    14     0    13     7    17    21     2     5     5     0    13 
   24     3    17     2    25    18    12    19    15    16     0     4    25    12     3    10     5    23     0 
   20     8     3    16    23    19     5    10     1    24    25     3    11    22     1     9    23    13    11 
   21     5     0    11     8     0    19    25    14     1    15     8    13    23    16     7    18    20    15 
   10    21     9     9    13     0    20     9    22    19    19    13     5     6     5     8     0    17    17 
   20     3    17    19    20    17    23     9    22     7    18    15     0     9     4     7     0     9    10 
    9    25    19    13    15    18    23    12     8    11    19     6     4    17    12     3     6    12    15 
    4     8     8    17    13    16    14     0     1    17    10    13    15    15    14    23    25    14     2 
   24    24    23    10     5    18     2    14     1     5    16     4     1    17    10    24    11    25     2 


    5     4     8    24    24    21    12    20     8    19     0     9    24    23     9    25    24    21    16 
   10    16     6    18    16     3    25    25     8    20    11    18    19     5     7    14    16     8    22 
    2     9     1    15    24     2    22    23    20    10    10    25    10    22    11    16    25    23     2 
   21     5    11     9    24     5    25    18     3    15     6     2     4    25    16     0    18     4    18 
    3    12    13    14     7    23    21    17     1     1    16    13     6    24    11     6     3    23    17 
    2    15    21     1     7    19     8    14    19    12     4    15    12    24    20    13    20     2    19 
   21     1    25    21    21    24    11     4    16     3     1    10    10     9     2    14     1     9    19 
   24    14     4     6     3    10     1     6    16    15    16    21    25    24    22    24    25     1     2 
   15     4    24    14     4    23    14    15     9    16     3    16    10    25    10    21    21    12     2 
   14    16     0     8    14    19    17    21     0     3    21     8    11    25    17    11     6    20     4 
    5    22     6     0     0    19    16    13     0    11     3    16    13    12    19    14    15     8     1 
   18     0     6     2    20     2    23     0     8    12    15    19     3     6     1    23     7    14     5 
   24     0    14    21     3    23    18    11     0     8    21     7     1     5    11    24    12    25     4 
    9    15    16    17    17    21    11     1     7    15    11     0    15     7     2     9    24    14     9 
   22     9    10     0    10     5    16    25    21    20     1     5    20    17    11    25    11     4    24 
   13    18    12    10    24    15    21     9    13    18     8    23     6     8    11     7     0    23    11 
    8     8    24    16     7     6     9     4    19     2     5    13    22     1    14     2    21     3    24 
   19     3    14     9    24    18     9    25     9     5    24     2     3     4    24    15    18     7     8 
    7    25     1     5    18    18    19    23     5    10    22    21    10     1    21    14    10    25    24 


   23    16     4     4    14    11     8     1    24     1     6    18    17    20    15    18    13    14    17 
   20    13     4    19     9    19    22    15    22     8    24    12    20    17     7     3    16    15     0 
   10    10    21     9    25    16    10    21     2    15     9     9    22    12    16    16     4    20     5 
    5    12     1    12    20    14     3    17    20    19     3    21     3     5    18    15     5     5     9 
    7     0    22     2     2     9    12    11     2     7    11    13     3    10     1    12     0    20    18 
    0     2    25    25    11    21     4     7     1    16    13     3     6    15     9     1    15     4     0 
    8    13    16    10    24    11     6    15    21    23    11    12     9    13    23    14    21    13    10 
    5     9    24    23    16     1    22     3    23    21    15     8    16    16    18    22    20     4    23 
    7    18    15    16    20    21     3     0     7     4     0    16    15    17     4    22     8     7    14 
    5     3    19    25     7     2     3     1    17    17    17    14     7    13    21     4     3    16    19 
   10    13     9    18    24    19    25     0    25     2    24     7     2     1     8    15     7    13     1 
   10    21     7     8     3     6    21    14     0     6    20    13    16    25    12    13    11     6     5 
    4    25     1    21    20     2    24    20     7     1    21     3    12     3     4    18     3     0    20 
    8    10     0     7    16    18     0     8    20    18    22    22    16    24     8    21     2     8     8 
    0     0     8    22     3    14    22    13     0    14    21    25    23     3     7    20     3     2    14 
   13    12     4    24    15    17    10    20    10     1    13    24    21    16     9    20    18    15    20 
   23    20     5    25    13    23     8    20    14     4     7     4     7     9    11     3     8    15     0 
   21     6    16     2     6     5     7    23     9     3    24    14     8     1    12     3    17     6    21 
    2     0     8     7    17     3    24    14    20    15    18    21    20    14    15     0     2    13    21 


    4     6     3    25     4    19    22     5    20    10     1    18    12    14    24     8     8    12    21 
    3    16    25     8    17    12    21    24    17    19     6     5    19    10    19    19    22    23    20 
   24     1    17     2    17     1     0     9    17    18     0    13     0     8    17     4     5    15    18 
   18    24     3    17    12    12    12    23     5     0     5    24    20    16    15    11     6     1     4 
    8     2     2    14    25     3     5     9    23     5    13     3     2    11    15    15    18    24    14 
    2    11    22    16     4    19    24    23    11     3    24    21    20     0    10    20    15    18    25 
   16    12     4     6     9     6     3     2    20    20    20     3    23     7     4     2    25     7    17 
    2    23     2     6     4    22    20    23    15    10    12    24     4    21    11    13    16    25     1 
    2    20    20    11    13    11    11     3    10    10    15    13    10     9    13     4     3    13     9 
    8     2    11    12    11     3    25    23    23     4     1     7    25     9    15     6     0     9    19 
   25    22    23     3    13     6     1     2     7    22    24    24     9    13    16    16     3     9    15 
    1    16     0     0     2     2    17    21    13     8    18     8     5    15    25    21     9    17    25 
    1     9    20    19     9     8    21    11    12    15     0    17     3    23     6    20    17     4     0 
   20     9     6     3     8    21     5     6    11    10    23    13    19     6    23     5    12    13    25 
    3     3     2     6     8     1     9    12     9    24     9     3    11    18    22    25     7    14    21 
    0    13    17     8     1    15    12    10     6    10    20     0    10     3     1    14    15    12     8 
   24    20    14    16    17    23     7     1    10     2    10     1    18    15     9     2    24     4    24 
    6    20     4    11    21     2    15    19    10    16     1     7     2     9    15     2    20    20     6 
   12     3    11     6    21     8     8    20     1     6     4     6    25    10     0     5     6    14    10 


    8    23    15    19     3    24    16     4     3     3     5    17    20    14     8    24    24    17     3 
    7    11    17    21    11    23     6    21     8    20    14     4     9     7    18     0    16     2     6 
    9    12    25    10     5    15    25     8    20     5     2     4     3     0    20    12     9    25     3 
   19    13     4    19    24    19     4    12     1    14    25    19     2    12     9     0    13    17    16 
    3    25    25    12    21    10    23    18     4     0     1     0    16    12    16     6    12    24     1 
   11     1     5    19    16    25    17    12     8     3    17    11    13     6    10    16     2    16    22 
   20     6    15    14     6     5    22     9     9    22    12    20    16     6     6    11    11     5    14 
   12    21     9    14    10     6    16     9     8     7    21    14    24     3    16    10    13    22    16 
   25     5    13    11     5    21    15    11     3     4     3     2     3    16    21     1    16    24    18 
    1    11    16    22    23    14    21     9    16    13    13    14     8    14    13     1     9     6     2 
    7     9    22     8    24    18    17    17    21     9     2    19    11    18    11     7    20     1    10 
    1    10     1    11     1    13    18    14     3    21     4     1     6    13     8    12    13     7     3 
   23    14    11     1    25    17    16     4    22    13     5     9    22     0    23     3    24    16    10 
   22     9     3     8    17     6    18    19    22    19     6    11    19    22    21     1    21     9     4 
    7     1     1    11    16    24    11    24    18    24     7    21     0    16    19    11    10    12    16 
   16     7     0    21     6     8    21     7    16    25    23     1     1     9    13     5    24     6    16 
   25    15     8    25     1     7    18     8    14    23     4    12     7    22    23     4    15    18    22 
   14    17     6    16     1    10    17    12    24    20    15     2     8    25     3     8    10    14    20 
    9    20    25    23    23     4    14     7     5     4     9    23    10     6    17    21    12    24    14 


    9    18    22    24    17     5    22     6     1    13    12    20     6    13    10     8     4    15    22 
    0    12    18     7    22    20    17    23    23    11    23    22    12    18    24     3     7    12     1 
   16    16     3    17     1     7    11    12    23    15    16    17    12    15     5    13    22    18    13 
   25    11    11    23    14    15    19     4    24    25    16    23    16    19    14     3    16    18    18 
   23    15    19     9    19     1    10    13    17     8     8    15    15    18    18    15     7     3    18 
   22    22     1    24    22    22    19    25    20    13     7    11    21    13     6    22    25     3    19 
    2    24     3     5    25     9    23     0     3     7     3     4     3    25     9     3     6    17    20 
    4     2     6    15    16     9    10    25     2    15     7    18     3     7     5    12     2    24    16 
    0    17     1     4     3    12     8     8     2    25    12    20    18     4    10     3    15    10     6 
   15     5    17    10    15     7     6    14    19     7    11    22    11     3     2    23    21    17     1 
    7     7    21    20     5    24    23    10    20     9     0    22     1    20     9     2    11    22    13 
   13    10    23    20    25    25     7    12     7     9    20     4    12    23    12    13    11     5    19 
   22     2    11    21     9     1    12     4    12     5    17     3    10    25     3    13    24     0    17 
    0    13     8    19     1    19     0     1     0    13    24    15     5     6    15    25     7     1     8 
    4     5    12    11    15    21    19     7    19     9    19    10    19    24     8     0    18     1     7 
   13    19    10     4    25     8    22     8     6     3     9     7    14     0    18    15     2    13    16 
   11    15     2    22     3     6    23     3    16     3    21     5     9    10    11    21     5     2     9 
    3    18     0    21    25     4    21    14    25    17    13    13     6    24     8    23     1     8    24 
   15    11    15    24     6    24    17    14    18     4     7    12    13     2     8     2     1     9     3 


