    0     0     0     0     0     0     0     0     0     0     0     0     0     0     0     0     0     0     0     0     0     0 
    0     9     1     7    15    22     7     7    18     8     5    25     0     3     5    16     7    13    25    15     0     0 
    0    15     9    11     4     2    10     4    13     3     8    21     1    10    13    16     7    14    15     7    17     0 
    0    14     4    10     2    17    13    12     9    13     7    22    17    16    13    20     4    12    25    24    11     0 
    0    10    17     4    16    14    20     4    23     4     0     5     5    12     3     5    12    14    17    11     8     0 
    0    19     3     8    18     5     2    17    14    25     5     2     5    15    16     9     1    23    13    19    13     0 
    0    15     0    17    11    18    17    20     0    10    13    11    14    23     5    19     3     5    16    21    10     0 
    0     8    19     7    22    19     6    17    15    13    21    23     1     0     2    14     0    15     3    12    17     0 
    0     2    19     1     6    19    21    24    15     3    19     9     5    18    16     9     2    24    17    13    22     0 
    0     0    18     8    22    13    17    22     7     5    22     7    10    18    12    11    15    15    13    20     0     0 
    0    11    10     7    12    25     3    15    17    21     8     7    16    21     3    13    16     2     1     8    22     0 
    0    12    17     5    21    10    24    22    12     6     6    13    12    24    10    23    14    25    17    24    21     0 
    0    18     2    18     8     1    10    17    18    21     2    25    23    19    16    18    19    11     3    15    25     0 
    0     6     5     1     2     9    23    17    20    15    24    25    19    11    25     1    14    14     6    13    24     0 
    0    19    17    19    12    10    21    16     4    21     3     9    22    24    14    19    16     3     4    19    17     0 
    0    14    24    13    14    19    21     6     0     1    10     2    12     8    18     0    18    25     4    10    12     0 
    0     8    15    15    14    24    22    10     1    18    19     6    12    23     4    10     1    20     7    13    16     0 
    0     3     4    24    11    23     5     7    18    19    20    16    15     3     9     6    25    19     3     4    21     0 
    0    22    15     4    17     1    13    10    22    22    17    20    22     5    20    20    22    13    24    21    10     0 
    0     8     7    13     8    20    24    22    17    24     9     0    14    24    24     0    24    25    24    12     0     0 
    0     9     9     0     5    12    14     1    11    15    10    12    11    12     2     6    15    19    24    12    20     0 
    0     0     0     0     0     0     0     0     0     0     0     0     0     0     0     0     0     0     0     0     0     0 


    0     0     0     0     0     0     0     0     0     0     0     0     0     0     0     0     0     0     0     0     0     0 
    0    15     8    24    17     6     8    15    20     1    18    25    15    25     5     1    15     8    25    24    25     0 
    0     0     6    11     1     4    14    21     2     5     4    22    17    17     4     8    12     0    11    20     1     0 
    0    20    21     3     0    25    24     3    17     8    21    21    13    19    14    19    11    18     1    20    21     0 
    0    11    20     4     1     0    23     8     4    21    14     4     8     9    16    19    14    24     1    14     5     0 
    0    16    23    23    11    21     5    15    23    24     2     0    24    17    22    18    18    24     1     8    13     0 
    0     7    20    20     4     4    11     8    17    16     5    20     7    11     2     2    16     7     8    17    15     0 
    0    11     9     6    10    17    16     6     8    17    22    19     8     1    16    17    11    20    15    21    20     0 
    0    14    15     2    15     9    14    24    14     0    22    18     7    18    20    18     5    16    15     5    11     0 
    0    23    21     0    13     2    15     5    23     1    19    19    24    23    18     0     2    22    22    13     3     0 
    0     2     5    12     6    24    22     5    24    19    13     8    23     2    14    10    12    18     4     5    16     0 
    0     8     5     5    11    22     3    20     6    15     1    15     8    20    22     6     9     1     6     4    20     0 
    0     2    12    15     5    16    14    24     2    21    13    21    17     7    11     9    11     0     8     4     8     0 
    0    21    17    13     7    13     9    12     6     3    18    25     0    17    23    18    17    24     9    15     2     0 
    0     3    10    21    13     1     7     9    22    15    22    12    18     9     7     1    19    13    19    14     6     0 
    0    22     5    18    25     7     7     1     9     3    20    13    11     2     8     1     0     4    22    12     0     0 
    0    13     4     9     1    18    24    10     9     9     5    13    25     3     2    22    18    18    24    21    22     0 
    0    20    16    25     2     6    14    24     8     5    20     0     3    11    17     4    21    20     0    14    23     0 
    0    21    14    17    16    21    24     2     5    17    24    19    21    12    21    21    24     3    19    21     1     0 
    0    11    24     9    14    17     8    10     4    25    11    10     1     6    23     5    19     8     7    17     7     0 
    0    18     3    17    20    20    14     2     4    19     6    16    20     2     9    11     3    12    13    14    11     0 
    0     0     0     0     0     0     0     0     0     0     0     0     0     0     0     0     0     0     0     0     0     0 


    0     0     0     0     0     0     0     0     0     0     0     0     0     0     0     0     0     0     0     0     0     0 
    0    18    15    24     7     0    10    12     9    18    14    15    15    17     0    20    22    25     8    14    12     0 
    0    25    22     1    25    18    22    13    18    12     2    19     1     8     1     4    18     0     0     8    23     0 
    0    23    24    23    23     9     6    23     3     6    14    18     9     5    10     4     9    19     1    13     2     0 
    0    14     7     2    25    18    21    15    16    22     3    23    12     3    24     9     7    14     8    12     0     0 
    0    24    19    17     4     6     9    21    24    13     4    24    24    23    15     8     8     0     7     9    22     0 
    0     5    25    18     7     3     8    22     9    19     7     2    14    13    15    13     3    25    25    11     6     0 
    0     2     1    17    25    24     6    20     6    25    16     5     5     0    11    12    16     1    15    19     3     0 
    0    13    10    13    20     0    19    10     5     0    12     8    14     2    23     4     5     6     5     5    22     0 
    0     5    11    25    10    18     4    22     2    11     5     0    24    20    12    10     4    15    13    10    21     0 
    0    19     0    15     7    16     0     6    13     3    25     0    11    10     1    17    18     5     1    17     5     0 
    0     0     6    20     0    13    18    25    18    23    21     1     7     3    21    18     9     5    10     4     8     0 
    0    15     1    13     4     7     9    13     4    17     3     7     4    17    25     9     3     7     9    22     3     0 
    0     4    18     1    14    19    13    23     2     4    13    20    17     2    13    21    14     3    17     5    18     0 
    0    15     4     6     4     3     5     3    16     3    16    19    25     6     8     4     3    15    22    22    21     0 
    0    19    15     1    23    24     2    23    16    19    10    24    22    24     8    25    21     1     8    11    13     0 
    0    14     8     0     5    14    19    21     9    24     0    18    22    10    24    23    18     8     0     2    19     0 
    0    24    16     5    22    13     3    11     6    25    10     1    23    23    20    23     8    19     5    14    19     0 
    0     8     5     7     2     2    19     4     6     1     1    15     1     8    24    23    18     9     7    17     8     0 
    0     7     6     9    22    18    11    23    24    11    23    22     7     6    22    15    20    22     7     3     9     0 
    0     1     6    22     7    21     1     9    16    16    10    15    15     7    13    12    16    22     4    21    17     0 
    0     0     0     0     0     0     0     0     0     0     0     0     0     0     0     0     0     0     0     0     0     0 


    0     0     0     0     0     0     0     0     0     0     0     0     0     0     0     0     0     0     0     0     0     0 
    0    21    11    19    18    11    13    15    23    23    24     1    19     0     7    24     7    13    15    13    13     0 
    0     2    10    13     0     4     0     1     6     9     5     0    17     0    25    15     4    11    23     0    19     0 
    0    24    21     5    12    20    22    10    19     9     1     2    23     5     2     6    10     6     1    20    18     0 
    0    25    20     7    17    14    11     2     3    11    21    19    19    16    17    16    21    15     2    15    23     0 
    0     3     1    13    18    25     6    20    18    15     8    15    21    19     7    13    12    19    17    12    24     0 
    0    14    13    17    17    16    13     3    17    16    23    16     9    25     4     9    16     2    15     5    12     0 
    0    18     4    18     2    12    20    25     4     5    14     8     4    22     4    15    16     6    22    19    13     0 
    0    22    23    18    15    24    17    13     2    14    10     2    15    19     9     9     7    23    12    23    12     0 
    0    23    25     3    19     1    11    22    12    14     1     3    24     6    25    18    21    12    20     0    10     0 
    0    12     7     0    14     2    18    22    16    21     6     6     5    13    15     6    23     4    23     3     0     0 
    0    25    25    19    16    11     0     5     7     4     1     4    15     6    16    13     2     5    25    13     9     0 
    0    23     2    21    10    23    19    24    24    22     8     0    16    22    14    16    20     7    19    19    14     0 
    0     9     0    10    21     9    12    21     4     2    14     4     4    21     3     8    12    12     0    20     0     0 
    0     3    22    11    21     8    13    16    18    25     0     6     7     8     7    14    18    10    19    17     1     0 
    0     8    22    11     5    11    25    15    24    25     1    13     5     5    16    20     1    18    20    13    14     0 
    0    15     9    13     8     8    21    13    12     6    18    19     1    20    11    23    24    25    13     7    23     0 
    0     4     1     8    20    20    15     2    13    15     5     8    12    18     3    20    21    20     2    11    21     0 
    0     5     4    23    15     6    11    19    20    16    19     0    25    17    12    24    23     8     2     2    20     0 
    0    15     2    10    23     1     8     7    11     3    20     1    23    16    24    20    11    12    21    14     4     0 
    0     2    15    20    19    15     4    10    13     0     1    24    23    20     4    15    12    17     2     8    24     0 
    0     0     0     0     0     0     0     0     0     0     0     0     0     0     0     0     0     0     0     0     0     0 


    0     0     0     0     0     0     0     0     0     0     0     0     0     0     0     0     0     0     0     0     0     0 
    0     9    16     4     9     7     2     9     2    12    11     1     9     8     9    11     9    12     2     5     6     0 
    0     0     1     6     8     9     9    11    17     0     1    23    12    17    12     2    12     6     9    16    25     0 
    0     6    14     1    12    19    12    21    20    24    24    14     0    16    18    16    11     7     3    24    14     0 
    0     7    13     3     1    23     9     3    22    21    24     0    25    19    25    15    11     3    17    17     6     0 
    0    12     8    14    10     0     7    15    19     7     2    19    16    17     5    16     7     3     1    10     3     0 
    0     9    21    13    13    22    19     4     5    13     1     6     7    25    23    19    16     7     7     2     9     0 
    0    20    22    19    25     8     1    23    16    17    12    19     2    16    16     2    24     7    10     0    10     0 
    0    16     2    22     5    23    17     4    17    24    25    20    11     0     3    18     7    16     7    19    11     0 
    0    23     8     2    15    13     2    25     0     1    11     4     3     1    16    21    18    15    20     9     3     0 
    0    11    21    23     9     5    17    14    15     3    12    20     9    13     9    10     7     5    19     4     8     0 
    0    14    22    14    15    23    20    22     4    19    13     0    20    21     5     7    25    19    17     9    11     0 
    0     7     4    14     1     9    18    19    14     7    23    17    11     3     4     5     9    19    25    17    19     0 
    0    12    19     3    21    16    11    10     8    25    24    25    11     0     5    16    14     6     7     5    24     0 
    0    12    24    21     1    23     1     0     6    23     9    10    10    16    14    22    13    19    12     6    20     0 
    0    21     1    13     5    23     0    24    16    13    25    24     8    21    24    18    18    17     2     3    25     0 
    0    23    19    22     2    10     7    19    11    12    19    14    16    17     3    10     2    13     9     8    15     0 
    0     8    14    10     3    19     9    25    19     7    24    16     4    16    21    17    14     4     9    12    15     0 
    0     7    10    17     5    13    19    12    14    13    16     1    18     9    16    20    19    22     5     2     5     0 
    0     4    12    13    16    15    24     9     7    14    23     4    22     0    20     5    12    16     0     6     1     0 
    0    19     0    16    23     4     9     1     0    21    25    15     0     8    21     4     0    14     2    14     2     0 
    0     0     0     0     0     0     0     0     0     0     0     0     0     0     0     0     0     0     0     0     0     0 


    0     0     0     0     0     0     0     0     0     0     0     0     0     0     0     0     0     0     0     0     0     0 
    0    23    19    24    25    11    18     5    11     5    10     1    17    16    15     2    10    19    15     2     8     0 
    0    23    13    15     6    13     4     7    19    22    24     7    19    16    11     6     4    17    19     9    17     0 
    0    10     3    14    15     2    20    18     3    11     0    24    22     3    25     6    16    13    16     8    10     0 
    0    19     2    12    18    10    25    17    12    20    25    21     4    17     0     6    11    15     0     3     1     0 
    0    24    10    12     1    20    22    13     2     0    11    16    16    12     7    14    23    23    20    17    17     0 
    0    14    14    18     6     7    18     2     8    10    13    14    21    25     1    21    18     9    17     0     0     0 
    0     7     4    24    24     5    20    24     4    10     9    19    23     7     9    21     4    12    21     5     8     0 
    0    24    20    19    17    13    16     2     8    15     2    14    13     0    10    23     2    11    21    24    14     0 
    0     4     7     3    23     6    17    24    10    20     0    15     4    17     1     1    24     5     2     8     2     0 
    0    21     1     8     0    20    25    12    22     1    17    15    14    18    24    10     0    23    20    18     7     0 
    0     6    14    12     5    14    20    17     8    23     8    25    16    19    11    14    20     8     2     1    22     0 
    0     2    18    22    16     5     8     8    22    14    14    12    19    10    19     5     9    18    25     6     4     0 
    0    16    11    18    18    16    21    14    12    16    10    24    23    23    25    12    22    24    25    14    18     0 
    0    21    11     8     5    13    21    17    18     2     8    17     8     7    23     2    10    18     5     7    22     0 
    0     2    20    13     8    23    23    11    16     5    11    21    12    15     3     2    20    13     4    24    21     0 
    0    10     0    17     4     9    22    13     1    10     2     2    15     8     8    14     0    19     9    15     3     0 
    0     2     3     7     6    19    22     0     9    13    11    25    24    15    19     2     6    19    25     8    19     0 
    0    10    22    15    16    17     1    21     9     4     5    19    12     9    17    22     1     3    15     4     2     0 
    0    13     8     8    17     8    16    11    24    20     5     2     0    24    21    23     5    25    14    25     2     0 
    0    14    22     4    23     3     5     4    23     0    15     7    18     9    22    15     3    25    10    11     9     0 
    0     0     0     0     0     0     0     0     0     0     0     0     0     0     0     0     0     0     0     0     0     0 


    0     0     0     0     0     0     0     0     0     0     0     0     0     0     0     0     0     0     0     0     0     0 
    0    14    24    22    22     3    13     8    14    25    10     4     8    24    19    17     0    18    10     8    17     0 
    0     1    22     8     9    10    22    21    16     7     5    17    17    15    13     5    25    20    12    18    13     0 
    0     1    10     1    19    21    19    23    20     1    12    19     0    17     4     6     3    11     2    12     3     0 
    0     2    13    16    24    14    25     7     0    13    14    17     8    16     8    21     8     5    24    18    17     0 
    0     6     9    18    10    13     6    13    22    11    10    20    15    23     2    11    13    12    12    17    15     0 
    0    11    12     1     6    23    15     7    24    14    21     2    13    11    24    10     6    10    16    22    19     0 
    0     8     5    10    20    16    15    20     2    16    17    24    10     0     0     4     7    23    20     4    19     0 
    0     6    24    15    21     5    22    15    25     7    22     7    20     0    25    20     7     2    22    12    18     0 
    0    14    20    15    13    16     3     3    25     4    19    23    10     1    18     6    24    14    15    18     8     0 
    0     7    15    21    21    25    16     2    11     3    12    22     7    20     1     9     1    12     9     3    23     0 
    0     0    25    21    17    11     7     0    17    25     9     9    13    13    19    20    23    23     0    17     1     0 
    0    16     8    24    14    16     3    13    19     4    16    19     6    16    16    15    15     5    18    19     0     0 
    0     6    21     7     5    22     6    19     2     8    17     9     6    15    24    13    23     2    13    17     6     0 
    0    11    15     0    15    25    15    14     9    22     6    21    16     0    16     6    15     5     1    23    14     0 
    0     1    23    10     7     2    15     7    12    12     1     3    22    11     9    10    10     8    10    10    11     0 
    0     1    24    21    13    18    12    25    20    10     8     3    12     9     0     9     0    25    25    10    24     0 
    0     0    22     1    17    20    12    20    16     4    16    12    16    19     1     4    10    25     8    23    15     0 
    0    16    25     2     4    15     2     0    15    24     4     4     7    18    10     0     8    20    23    18    24     0 
    0     7     9    10    18    11     5    17    15     5     6    17    17    15     2    13    17    21     9    17    23     0 
    0     0    20     0     2    25    11    19    19     3    12     7    10     5    16     2    24    24    15     2     4     0 
    0     0     0     0     0     0     0     0     0     0     0     0     0     0     0     0     0     0     0     0     0     0 


    0     0     0     0     0     0     0     0     0     0     0     0     0     0     0     0     0     0     0     0     0     0 
    0    18     2    21     5    14    22    14    18    11     6    25    12     8     9    15    16    21    12     7    11     0 
    0     3    12    19     2     3    25    14    14    15    18     6    22    25    25     0     5     9    20    11     6     0 
    0     1    10    21    10    14    20    22     1     9    17    23    21     1    22    21    23     3     2     1    24     0 
    0    10    20     6    23    10    24    18    25    25    17     6    21     8    16    24    24     3     1    12    23     0 
    0     5    19    13     6    24    11     4     5    18    19    20    21    22    11    25    13    25    18    23    22     0 
    0     6     3     9    10    10    16     9     9    16    24    21     8     7    22    16    24     2     0    19    12     0 
    0    15    24     4    19    21    14    17     0    11     8    23     0     2    14     1    24    12     6     7    12     0 
    0     2    23    19    22     7     5    18     9     8     1     1    23    22     6     9    20     5    24     7    21     0 
    0     3     5    14    22     2     2    22    16    25    12    25    22     3    15     2     7     3     3     2    20     0 
    0    16     4    24    14    12     5    11    22     9    18    14    18     6    15    11     8     4    17     7    23     0 
    0    21     3     2    14    13    20     1     9    19    25     5    25    21     6     4    14    13    12    20     3     0 
    0    21    17    17    11    23    16    23     2     0    14    13    11     7    14    11     9    13     3    22     8     0 
    0     2    11    10    24    14    10    23    12     2     6    22    14     8     7    23    20    20    24     3    16     0 
    0    14    14     1    20     1    13     0    23     0    23     7     0    16     0     9    11     7    16    23     3     0 
    0    25    19     1    22    25    12     3    22    15    13    25    12     3     7     2    12     1    21    24     4     0 
    0     7    21     0    10    21     8    13    12    10     2    18    12    25    14    24    12     8    12     2     4     0 
    0    20     3    10     9    19    25    12     3     5    19     5     4     8     3    19    25    20    20     1     3     0 
    0    25    10     4     8    10    23    13    13    19    11    11     5     7    13     9    17     3    25    13    18     0 
    0     7    10     2    20     1    22     9    15    10     9    25     3     6     7     8    11    11    17    17     8     0 
    0    14    18    10    20    14    15    22    17    19     4    25     8     2    25    19    18    15     4    11    12     0 
    0     0     0     0     0     0     0     0     0     0     0     0     0     0     0     0     0     0     0     0     0     0 


