 1772  1751  1868  1828  1853  1789  1692  1798  1739  1811  1953  1976  2045  1972  1857  1740  1973  1644  1844  1792  1877  1985  1990 
 1825  1866  1874  1964  1806  1730  1737  1699  1821  1759  1842  1665  1851  1927  1986  1865  1905  1708  1746  2008  1991  2128  1850 
 1861  1804  1893  1703  1665  1569  1659  1600  1731  1839  1812  1811  1714  1548  1796  1923  1846  1745  1751  1878  1991  2190  1903 
 1859  1950  1892  2071  1740  1588  1465  1686  1822  2124  2057  1925  1650  1746  1800  1798  1831  1861  1868  2005  1824  2084  1936 
 1808  1822  1969  1920  1889  1906  1732  1704  1888  2074  1997  2100  1662  1698  1772  1775  1893  1837  1928  2093  2084  2065  1963 
 1970  1812  1821  1884  1988  1911  1931  1882  1890  2062  2019  1901  1947  1976  1865  1904  1785  1861  2009  2076  2088  2218  2026 
 1762  1897  1744  1717  1748  1899  1923  1873  1889  1952  2044  1940  1948  1847  1621  1724  1814  1858  1939  2021  2021  2067  1946 
 1952  1981  1562  1575  1811  1781  1863  2038  2050  2113  2137  2127  2024  1743  1826  1692  1817  1922  2082  2173  1991  1939  1940 
 1904  2063  1753  1843  1853  1820  1692  1792  2037  1987  2104  1838  1764  1772  1770  1739  1956  1926  2150  2162  1976  1744  1672 
 2080  2199  1969  1840  1927  1812  1753  1970  2115  2131  1920  1966  1932  1913  1962  1775  2009  1860  2047  2004  1982  1813  1874 
 2076  1800  2022  2006  2019  1712  1713  1828  1856  1718  1908  1981  1850  1966  1970  1952  1909  1759  1854  1847  1914  1730  1681 
 2061  2018  1936  1832  1781  1842  1904  1722  1772  1909  1900  2042  1904  1944  2098  2168  2113  1714  1814  1784  1928  1893  2059 
 2039  1670  1858  1834  1836  1757  1658  1770  1730  1829  1878  1868  1743  1819  2095  1990  1991  1844  1975  1874  1940  1766  1900 
 1830  1988  1848  1796  1719  1669  1804  1750  2115  2075  1957  1898  1680  1740  1955  2020  1927  1684  1974  1692  1905  1853  2021 
 1690  1683  1886  1890  2032  1881  1866  1873  1799  2255  2009  1873  1611  1712  1852  1831  1987  1893  1911  1901  1878  1850  2005 
 1746  1880  1921  1981  1923  1945  1870  1906  1937  1833  1837  2151  1677  1791  1768  1888  1802  1860  2066  1925  1935  1776  1972 
 1691  1750  1758  1809  1640  1811  1846  1916  1834  1939  1883  1861  1821  1705  1707  1712  1726  1824  1865  1982  2032  1862  1866 
 1972  1652  1782  1810  1842  1906  1982  1844  1987  1772  1911  1863  1934  1825  1823  1801  1713  1700  1849  1960  1948  2120  1959 
 1905  1844  1880  1907  1769  1765  1901  1751  1942  1882  1913  1926  1889  1771  1938  1947  1859  1799  1795  1946  2046  2144  2025 
 1932  2144  2015  1729  1719  1787  1714  1846  1741  1827  1989  1698  1896  1927  1997  2095  1830  2019  1901  1942  2083  2136  2022 
 1957  1780  1842  1826  1727  1703  1695  1818  1758  1760  2047  1804  1857  2053  2033  2036  1929  1927  1902  1844  1923  2152  1989 
 1942  1845  1811  2001  1963  1904  1663  1662  1943  1884  2025  1816  2092  1830  2081  1990  1990  2174  1671  1833  1656  1857  1752 
 1679  1635  1709  1853  2076  1844  1729  1869  1942  1990  1938  1808  1792  1659  1762  1938  1904  2013  1807  1760  1784  1830  1757 


 2091  2419  2236  2243  2067  2220  2012  1966  2003  2198  2378  2200  2638  2330  2258  2203  2172  2131  2242  2364  2553  2464  2500 
 2044  2346  2249  2289  2030  1917  1953  2018  2182  2040  2221  2065  2338  2251  2437  2465  2323  2217  2073  2376  2384  2475  2333 
 2244  2328  2376  2155  1745  1680  1862  2237  2070  2248  2516  2206  2345  1967  2277  2205  2281  2162  2240  2265  2403  2352  2181 
 2221  2290  2220  2141  1941  2010  2008  2199  2430  2570  2594  2285  2008  1985  2151  2286  2385  2195  2329  2467  2425  2404  2408 
 2216  2236  2184  2228  2365  2230  2117  2097  2143  2321  2416  2516  2067  2103  2211  2037  2062  2178  2264  2334  2275  2507  2306 
 2411  2222  2248  2213  2127  2260  2221  2162  2254  2526  2390  2318  2265  2181  2103  2064  2109  2156  2050  2396  2285  2525  2551 
 2292  2107  2013  2053  2244  2353  2211  2148  2110  2241  2209  2245  2097  2152  2116  2326  2207  2395  2316  2346  2267  2371  2389 
 2455  2148  2052  2138  2150  2315  2332  2305  2523  2637  2605  2483  2415  2153  2078  2111  2297  2468  2618  2530  2515  2286  2375 
 2559  2341  2163  2388  2344  2038  2197  2379  2562  2499  2476  2097  2126  2064  2042  2093  2454  2320  2655  2636  2389  2253  2082 
 2390  2224  2304  2387  2325  2085  2208  2397  2571  2481  2387  2378  2385  2362  2210  2162  2175  2190  2525  2424  2410  2098  2234 
 2316  2341  2264  2259  2230  2096  2301  2146  2468  2288  2283  2253  2017  2235  2436  2415  2359  2353  2363  1868  2093  2350  2320 
 2472  2370  2280  2359  2288  2045  2156  2148  2238  2269  2331  2413  2452  2446  2506  2499  2472  2377  2288  2091  2267  2171  2159 
 2378  2061  2215  2083  2277  2052  1902  2115  2230  2218  2224  2216  1911  2242  2459  2484  2502  2361  2124  2177  2326  2219  2176 
 2377  2376  2496  2520  2285  2158  2170  2141  2419  2497  2479  2368  2089  2029  2261  2333  2058  2266  2278  2336  2153  2122  2219 
 2245  2278  2446  2246  2239  2108  2236  2031  2335  2558  2366  2327  2070  2056  2433  2361  2321  2318  2292  2447  2101  2296  2501 
 2102  2387  2411  2434  2312  2416  2386  2173  2389  2377  2290  2068  2077  2257  2222  2191  2178  2308  2284  2350  2230  2308  2280 
 1974  1997  1933  2346  1969  2113  2113  2295  2228  2130  2047  2403  2121  2094  2229  2169  2224  2222  2378  2486  2459  2218  2414 
 2171  2205  2198  2260  2256  2318  2225  2300  2209  2196  2172  2109  2225  2329  2164  2146  2106  2092  2212  2392  2419  2397  2322 
 2262  2164  2261  2333  2170  2168  2152  2011  2174  2302  2436  2341  2253  2303  2222  2250  2192  2094  2158  2351  2364  2571  2557 
 2436  2339  2460  2358  2134  2154  1993  2073  2161  2302  2420  2210  2224  2455  2574  2443  2297  2322  2283  2385  2567  2719  2422 
 2417  2118  2233  2247  2068  2010  1831  2079  2342  2344  2341  2074  2350  2588  2327  2399  2434  2408  2180  2155  2335  2523  2227 
 2361  2140  2268  2369  2220  2173  1973  2028  2205  2480  2559  2226  2261  2214  2346  2426  2519  2436  2009  2267  2151  2287  2050 
 2120  2231  2195  2122  2299  2457  2194  2173  2543  2549  2455  2273  2138  2207  1936  1980  2337  2535  2229  1998  2093  2107  2131 


 2015  2265  2144  2191  1980  2199  1937  2073  2055  2048  2138  2227  2223  2208  2029  2045  2121  1973  2048  2201  2374  2365  2322 
 2126  2159  2319  2312  1953  1950  1962  2098  2200  2059  2117  2019  2219  2356  2345  2354  2066  2004  1976  2245  2089  2428  2273 
 2188  2101  2212  2003  1863  1712  1892  2067  1994  2217  2364  2060  2046  1862  2038  2070  2187  2030  2047  2254  2327  2373  2243 
 1971  2231  2285  2305  1992  1805  1873  1971  2144  2427  2404  2183  1986  1822  2033  2155  2139  2112  2165  2229  2304  2313  2225 
 2130  2152  2253  2111  2183  2050  2075  1989  2096  2332  2220  2148  1988  2010  2235  2075  2057  1989  2123  2363  2369  2402  2201 
 2344  2110  2102  2188  2121  2177  2195  2201  2331  2528  2256  2212  2204  2405  1956  2041  2140  2036  2053  2233  2289  2320  2474 
 2235  2109  2094  1919  2135  2204  2126  2109  2073  2333  2255  2327  2086  2172  1979  2132  2135  2284  2196  2335  2283  2226  2354 
 2305  2295  1887  2048  2044  2053  2148  2288  2473  2507  2499  2339  2443  2169  2114  1802  1899  2377  2426  2356  2482  2263  2170 
 2286  2247  2181  2118  2087  2094  2040  2158  2324  2305  2341  2244  2184  1906  1899  1990  2303  2284  2290  2558  2234  2264  2076 
 2192  2533  2235  2136  2147  2241  2271  2265  2451  2470  2133  2230  2185  2234  2389  2236  2290  1925  2372  2380  2315  2106  2105 
 2352  2170  2296  2185  2041  2041  2104  2037  2324  2154  2251  2248  1930  2160  2197  2444  2458  2193  2150  2057  1999  2150  2001 
 2227  2136  2138  2238  2204  2036  2095  2097  1976  2243  2274  2359  2257  2335  2490  2485  2347  2099  2133  2194  2088  2241  2174 
 2324  2022  2086  2061  2163  1966  2081  2088  2098  2309  2267  2161  1831  2201  2311  2403  2308  2224  2302  2102  2211  2201  2037 
 2412  2366  2215  2210  2132  2086  2036  2112  2408  2440  2608  2333  1828  1962  2265  2366  2290  2121  2262  2159  2139  2100  2317 
 2094  2240  2395  2188  2217  2028  2156  2240  2171  2481  2347  2228  1979  1916  2234  2138  2277  2182  2318  2314  2165  2168  2372 
 1984  2317  2421  2369  2235  2257  2274  2090  2279  2281  2036  2238  1875  2114  2040  2179  2225  2076  2089  2363  2118  2180  2329 
 1922  2296  2083  2165  2020  2089  2157  2222  2134  2283  2102  2154  1909  2034  2028  2138  2023  2029  2373  2279  2400  2173  2127 
 2216  2001  1845  2151  2065  2127  2168  2325  2250  2140  2243  2280  2173  2124  2191  2102  2071  2055  2064  2243  2134  2324  2368 
 2196  2036  2193  2211  1967  2001  2108  2270  2241  2283  2230  2128  2347  2227  2179  2152  2049  2095  1978  2295  2546  2407  2472 
 2475  2396  2404  2155  2178  2160  1936  2002  2166  2231  2362  2116  2321  2356  2551  2364  2254  2331  2096  2291  2380  2569  2165 
 2249  2256  2224  2235  1967  2079  1934  1932  2210  2162  2156  2086  2201  2433  2315  2357  2294  2289  2145  2393  2376  2490  2309 
 2311  2107  2183  2426  2169  2130  1957  1930  2377  2361  2375  2252  2468  2185  2343  2281  2376  2240  1961  1994  1872  2345  1865 
 2120  1963  2090  2123  2194  2260  2050  2072  2302  2458  2414  2056  2064  2024  1985  2190  2240  2378  2172  2018  2119  2115  2235 


 2110  2333  2373  2278  2345  2386  2175  2192  2136  2456  2394  2416  2532  2436  2464  2195  2362  2233  2241  2449  2694  2531  2607 
 2274  2531  2410  2524  2254  2134  2137  2185  2334  2337  2412  2267  2448  2405  2587  2525  2522  2341  2290  2573  2604  2557  2361 
 2315  2382  2445  2185  2057  1966  2000  2275  2147  2408  2448  2484  2287  2142  2423  2328  2401  2359  2198  2489  2584  2591  2256 
 2357  2423  2497  2323  2103  2084  2102  2337  2319  2738  2704  2380  2257  2125  2292  2275  2464  2264  2480  2658  2403  2760  2485 
 2463  2306  2487  2369  2421  2283  2210  2157  2444  2323  2482  2714  2195  2213  2396  2287  2377  2264  2411  2667  2405  2595  2592 
 2407  2414  2353  2301  2287  2522  2427  2438  2528  2745  2644  2656  2420  2436  2393  2188  2232  2384  2364  2520  2589  2595  2549 
 2400  2277  2331  2184  2259  2488  2477  2443  2231  2415  2476  2417  2404  2305  2191  2202  2339  2515  2434  2449  2481  2609  2518 
 2529  2526  2186  2080  2285  2367  2485  2389  2605  2677  2846  2526  2607  2366  2183  2146  2309  2491  2687  2646  2637  2465  2467 
 2570  2410  2261  2363  2382  2231  2212  2483  2694  2599  2659  2269  2338  2399  2228  2077  2523  2424  2745  2707  2509  2310  2255 
 2764  2527  2367  2684  2428  2367  2430  2477  2819  2750  2421  2586  2421  2304  2457  2457  2601  2333  2522  2683  2554  2007  2332 
 2591  2425  2427  2482  2515  2167  2355  2245  2558  2318  2466  2318  2257  2379  2386  2500  2598  2518  2640  2111  2250  2548  2413 
 2742  2487  2483  2268  2397  2446  2324  2420  2355  2415  2526  2601  2363  2490  2704  2700  2526  2211  2279  2228  2438  2521  2444 
 2498  2328  2484  2235  2310  2234  2007  2338  2317  2309  2485  2392  2165  2324  2637  2610  2767  2397  2438  2329  2373  2280  2392 
 2612  2465  2460  2474  2405  2243  2306  2363  2460  2697  2549  2529  2106  2349  2384  2551  2442  2225  2487  2520  2374  2306  2356 
 2319  2360  2516  2536  2430  2378  2385  2267  2368  2741  2588  2542  2198  2243  2556  2479  2616  2322  2327  2437  2401  2449  2619 
 2238  2407  2494  2569  2417  2325  2480  2365  2334  2506  2443  2409  2040  2322  2343  2407  2358  2302  2285  2578  2351  2495  2472 
 2156  2274  2217  2590  2175  2212  2246  2514  2395  2283  2179  2440  2346  2221  2209  2269  2349  2442  2538  2583  2690  2321  2205 
 2346  2219  2243  2472  2345  2491  2435  2412  2433  2310  2580  2374  2432  2411  2276  2356  2249  2250  2367  2566  2406  2596  2503 
 2415  2306  2374  2508  2257  2194  2295  2236  2427  2518  2657  2404  2448  2391  2536  2487  2308  2244  2317  2425  2611  2763  2794 
 2576  2546  2592  2555  2343  2379  2227  2210  2162  2416  2561  2254  2616  2482  2748  2562  2472  2521  2337  2572  2603  2819  2476 
 2500  2183  2312  2430  2214  2117  2153  2242  2396  2254  2578  2118  2444  2658  2399  2656  2508  2656  2508  2391  2572  2711  2495 
 2495  2282  2322  2635  2537  2391  2176  2107  2324  2492  2676  2529  2497  2439  2512  2472  2614  2476  2221  2319  2124  2556  2134 
 2214  2152  2325  2117  2395  2344  2284  2359  2583  2693  2641  2256  2485  2225  2080  2302  2271  2776  2515  2206  2137  2269  2302 


 1928  1948  1908  1928  1882  1902  1833  1843  1926  1884  2015  1861  2159  2024  1950  1824  1900  2000  1817  2131  2129  2232  1945 
 1960  1967  1920  1964  1726  1687  1750  1834  1960  1785  1937  1755  2027  2019  2017  1926  1943  1768  1788  1914  1975  2257  1998 
 1816  1982  1973  1857  1799  1639  1646  1801  1789  1898  2020  1904  1779  1603  1899  1893  1932  1810  1826  2119  1992  2093  1972 
 1819  2115  2163  1996  1747  1636  1658  1840  1872  2251  2169  1934  1789  1665  1914  1786  1897  1892  1987  2146  2020  2121  2009 
 1992  2032  2006  1914  2021  1818  1955  1831  1796  2106  2003  2085  1973  1952  1779  1898  1846  1741  1851  2115  2096  2125  2001 
 2115  1961  1897  2052  1881  1877  1981  1957  1992  2123  1904  1978  1838  2083  1719  1893  1808  1757  1817  1942  2078  2175  2151 
 2022  1972  1781  1752  1938  2053  1973  1949  1901  2071  2103  2026  1924  1892  1954  1815  1970  2023  2051  2110  1994  2132  2116 
 2000  2031  1743  1805  1808  1754  1836  1936  2281  2202  2335  2219  2225  1944  1796  1475  1808  2072  2160  2238  2153  2035  1947 
 2202  1983  1907  1926  1912  1890  2018  1836  2104  2126  2018  1864  1889  1857  1878  1929  1993  1868  2062  2208  2307  1822  1875 
 1977  2192  2145  1972  1925  1974  2026  1922  2175  2093  1960  2092  2019  2045  1990  1881  2028  1811  2125  2083  2033  1839  1835 
 2036  1968  1968  1935  1865  1942  1949  1930  1986  2046  1977  1953  1730  1910  1967  2184  2123  1920  1867  1646  1973  1913  1952 
 2159  2005  1887  1896  1935  1804  1989  1783  1804  1997  2105  2055  1866  2051  2307  2252  2137  1868  2008  1719  1925  1869  2039 
 2048  1846  1875  1855  1830  1738  1713  1808  1953  2068  2115  1881  1728  1869  2176  2242  2073  1918  1900  1996  1960  1954  1993 
 2223  2013  2025  1898  1890  1823  1877  1977  2057  2243  2290  2117  1624  1718  2022  2145  1938  1981  2005  2096  1906  1925  2067 
 1866  2041  2126  2043  1875  1876  1991  1956  1900  2309  2105  2087  1802  1762  1954  2115  2084  1944  2144  2089  1968  1931  2109 
 1830  2011  2104  2129  2074  2071  2036  1812  1942  1962  1763  2078  1646  1813  1933  1974  1919  1956  1838  1861  1987  2043  2056 
 1827  1849  1958  1990  1701  1840  2065  2114  1911  1964  2019  1830  1720  1790  1850  1742  1943  2039  2051  2164  1991  1988  1960 
 1986  1768  1718  1961  1745  1896  2039  2078  1977  1911  2025  1867  2168  1885  1881  1873  1858  1718  1804  2015  2024  2176  2148 
 2042  1821  2025  1907  1846  1896  1797  1989  1951  1907  2035  2041  1960  1954  2011  2021  1809  1758  1890  1937  2192  2172  2169 
 2095  2095  2107  1907  1799  1894  1838  1797  2027  2018  2080  1835  2044  2095  2304  2179  1950  2083  1920  2128  2178  2318  2008 
 2200  2024  1947  2071  1798  1841  1671  1793  1899  2015  1836  1766  2096  2129  2264  2170  2071  2148  2017  2107  2073  2238  1988 
 2083  1821  1915  2023  1886  1948  1609  1901  2148  2011  2107  1981  2105  1767  2164  2000  2033  2058  1782  1843  1661  2092  1740 
 1781  1742  1841  1962  1965  1943  1824  1894  1988  2201  2166  1908  1857  1759  1773  2028  2042  2180  1862  1785  1799  1853  1913 


