 1772  1751  1868  1828  1853  1789  1692  1798  1739  1811  1953  1976  2045  1972  1857  1740  1973  1644  1844  1792  1877  1985  1990 
 1777  1899  1922  1902  1773  1700  1649  1669  1688  1820  1791  1732  1854  1904  1951  1872  1953  1733  1768  2029  2090  2038  1761 
 1861  1804  1893  1703  1665  1569  1659  1600  1731  1839  1812  1811  1714  1548  1796  1923  1846  1745  1751  1878  1991  2190  1903 
 1894  1916  1946  1944  1775  1628  1546  1589  1837  2057  2058  1872  1713  1806  1792  1845  1883  1824  1876  2079  1860  2054  1940 
 1808  1822  1969  1920  1889  1906  1732  1704  1888  2074  1997  2100  1662  1698  1772  1775  1893  1837  1928  2093  2084  2065  1963 
 1890  1863  1827  1853  1938  1930  1972  1865  1804  2112  2071  1952  2014  1935  1884  1847  1738  1933  2065  2007  2132  2153  2019 
 1762  1897  1744  1717  1748  1899  1923  1873  1889  1952  2044  1940  1948  1847  1621  1724  1814  1858  1939  2021  2021  2067  1946 
 1924  1981  1646  1566  1792  1832  1973  1863  2015  2128  2214  2007  1938  1760  1823  1755  1864  1928  2092  2118  1926  2061  1884 
 1904  2063  1753  1843  1853  1820  1692  1792  2037  1987  2104  1838  1764  1772  1770  1739  1956  1926  2150  2162  1976  1744  1672 
 2131  2088  1863  1992  1935  1806  1787  1974  2136  2107  1959  1924  1882  1853  1834  1865  1973  1907  1971  1956  1987  1703  1794 
 2076  1800  2022  2006  2019  1712  1713  1828  1856  1718  1908  1981  1850  1966  1970  1952  1909  1759  1854  1847  1914  1730  1681 
 2133  1901  1941  1823  1815  1762  1787  1841  1881  1904  1927  2039  1862  1982  2134  2086  2018  1742  1846  1714  1882  1932  1988 
 2039  1670  1858  1834  1836  1757  1658  1770  1730  1829  1878  1868  1743  1819  2095  1990  1991  1844  1975  1874  1940  1766  1900 
 1926  1896  1799  1831  1808  1594  1738  1780  2063  2133  1997  1857  1616  1939  2007  1940  1888  1742  1886  1806  1965  1781  2052 
 1690  1683  1886  1890  2032  1881  1866  1873  1799  2255  2009  1873  1611  1712  1852  1831  1987  1893  1911  1901  1878  1850  2005 
 1755  1925  1889  1955  1890  1914  1912  1890  1849  1926  1977  1983  1741  1788  1785  1882  1809  1885  1952  2026  1906  1808  1824 
 1691  1750  1758  1809  1640  1811  1846  1916  1834  1939  1883  1861  1821  1705  1707  1712  1726  1824  1865  1982  2032  1862  1866 
 1917  1720  1854  1862  1865  1892  1897  1888  1956  1744  1971  1832  1914  1793  1787  1824  1748  1778  1805  2062  2032  2008  1938 
 1905  1844  1880  1907  1769  1765  1901  1751  1942  1882  1913  1926  1889  1771  1938  1947  1859  1799  1795  1946  2046  2144  2025 
 2027  2054  1949  1823  1749  1799  1833  1787  1727  1833  1978  1702  1914  1892  2036  2058  1901  1959  1889  1978  2029  2198  1991 
 1957  1780  1842  1826  1727  1703  1695  1818  1758  1760  2047  1804  1857  2053  2033  2036  1929  1927  1902  1844  1923  2152  1989 
 1955  1818  1858  1933  2019  1931  1655  1634  1858  1976  2027  1784  1885  1916  2046  2018  2076  2089  1805  1778  1770  1844  1742 
 1679  1635  1709  1853  2076  1844  1729  1869  1942  1990  1938  1808  1792  1659  1762  1938  1904  2013  1807  1760  1784  1830  1757 


 2072  2404  2217  2381  2215  2091  2054  2017  2104  2053  2245  2288  2593  2330  2272  2234  2059  2230  2308  2301  2436  2424  2405 
 2044  2346  2249  2289  2030  1917  1953  2018  2182  2040  2221  2065  2338  2251  2437  2465  2323  2217  2073  2376  2384  2475  2333 
 2270  2285  2300  2120  1765  1733  1927  2205  2120  2231  2518  2187  2260  1896  2202  2228  2291  2192  2246  2320  2414  2482  2431 
 2221  2290  2220  2141  1941  2010  2008  2199  2430  2570  2594  2285  2008  1985  2151  2286  2385  2195  2329  2467  2425  2404  2408 
 2154  2224  2205  2141  2279  2291  2114  2126  2035  2535  2456  2342  2136  2066  2096  2013  2085  2302  2233  2394  2357  2471  2278 
 2411  2222  2248  2213  2127  2260  2221  2162  2254  2526  2390  2318  2265  2181  2103  2064  2109  2156  2050  2396  2285  2525  2551 
 2270  2133  2027  2033  2141  2435  2305  2049  2109  2297  2255  2324  2117  2195  2160  2244  2293  2393  2313  2383  2284  2427  2433 
 2455  2148  2052  2138  2150  2315  2332  2305  2523  2637  2605  2483  2415  2153  2078  2111  2297  2468  2618  2530  2515  2286  2375 
 2580  2261  2199  2399  2289  2144  2306  2321  2487  2516  2364  2207  2151  1943  1926  2201  2401  2405  2685  2569  2463  2185  2113 
 2390  2224  2304  2387  2325  2085  2208  2397  2571  2481  2387  2378  2385  2362  2210  2162  2175  2190  2525  2424  2410  2098  2234 
 2386  2296  2201  2245  2223  2075  2280  2105  2356  2227  2336  2281  2127  2220  2403  2539  2443  2211  2269  1934  2220  2205  2144 
 2472  2370  2280  2359  2288  2045  2156  2148  2238  2269  2331  2413  2452  2446  2506  2499  2472  2377  2288  2091  2267  2171  2159 
 2349  2039  2101  2166  2258  2080  1933  2070  2152  2272  2279  2240  2059  2202  2385  2405  2381  2288  2075  2292  2265  2242  2231 
 2377  2376  2496  2520  2285  2158  2170  2141  2419  2497  2479  2368  2089  2029  2261  2333  2058  2266  2278  2336  2153  2122  2219 
 2175  2293  2392  2329  2234  2117  2216  2162  2314  2596  2341  2266  2022  2020  2311  2335  2335  2385  2297  2475  2152  2198  2392 
 2102  2387  2411  2434  2312  2416  2386  2173  2389  2377  2290  2068  2077  2257  2222  2191  2178  2308  2284  2350  2230  2308  2280 
 1998  2142  2057  2268  1949  2166  2091  2336  2223  2255  2266  2310  2114  2116  2242  2193  2273  2122  2283  2455  2391  2390  2469 
 2171  2205  2198  2260  2256  2318  2225  2300  2209  2196  2172  2109  2225  2329  2164  2146  2106  2092  2212  2392  2419  2397  2322 
 2305  2178  2258  2265  2152  2149  2034  2222  2311  2188  2327  2322  2314  2277  2195  2301  2188  2091  2183  2333  2409  2569  2501 
 2436  2339  2460  2358  2134  2154  1993  2073  2161  2302  2420  2210  2224  2455  2574  2443  2297  2322  2283  2385  2567  2719  2422 
 2301  2278  2261  2225  2047  2139  1840  2066  2260  2335  2353  2086  2384  2591  2441  2310  2424  2380  2118  2263  2292  2488  2194 
 2361  2140  2268  2369  2220  2173  1973  2028  2205  2480  2559  2226  2261  2214  2346  2426  2519  2436  2009  2267  2151  2287  2050 
 2120  2155  2097  2241  2333  2395  2211  2257  2480  2485  2456  2210  2091  2269  2061  2116  2430  2393  2201  2024  2125  2148  2204 


 2015  2265  2144  2191  1980  2199  1937  2073  2055  2048  2138  2227  2223  2208  2029  2045  2121  1973  2048  2201  2374  2365  2322 
 2100  2290  2348  2315  1935  1798  1941  2046  2123  2023  2159  2096  2214  2220  2347  2216  2084  2150  1973  2398  2188  2334  2230 
 2188  2101  2212  2003  1863  1712  1892  2067  1994  2217  2364  2060  2046  1862  2038  2070  2187  2030  2047  2254  2327  2373  2243 
 1994  2219  2240  2269  2014  1885  1883  2045  2181  2357  2392  2137  1987  1873  2005  2211  2184  2058  2156  2367  2299  2322  2214 
 2130  2152  2253  2111  2183  2050  2075  1989  2096  2332  2220  2148  1988  2010  2235  2075  2057  1989  2123  2363  2369  2402  2201 
 2300  2156  2095  2181  2118  2104  2191  2277  2331  2477  2355  2224  2262  2354  1961  2004  2108  2085  2104  2262  2272  2353  2438 
 2235  2109  2094  1919  2135  2204  2126  2109  2073  2333  2255  2327  2086  2172  1979  2132  2135  2284  2196  2335  2283  2226  2354 
 2346  2180  1956  2032  2035  2180  2216  2243  2393  2576  2522  2279  2432  2034  2145  1894  1963  2348  2393  2428  2431  2324  2133 
 2286  2247  2181  2118  2087  2094  2040  2158  2324  2305  2341  2244  2184  1906  1899  1990  2303  2284  2290  2558  2234  2264  2076 
 2277  2285  2143  2355  2194  2109  2241  2297  2468  2494  2126  2236  2141  2156  2313  2278  2233  1972  2336  2219  2348  1979  2122 
 2352  2170  2296  2185  2041  2041  2104  2037  2324  2154  2251  2248  1930  2160  2197  2444  2458  2193  2150  2057  1999  2150  2001 
 2265  2144  2179  2205  2261  1971  2021  2141  2081  2321  2245  2302  2274  2330  2474  2328  2276  2167  2184  2137  2074  2182  2126 
 2324  2022  2086  2061  2163  1966  2081  2088  2098  2309  2267  2161  1831  2201  2311  2403  2308  2224  2302  2102  2211  2201  2037 
 2430  2302  2194  2219  2177  2103  2048  2056  2376  2455  2557  2355  1867  2103  2226  2393  2277  2094  2253  2138  2176  2038  2271 
 2094  2240  2395  2188  2217  2028  2156  2240  2171  2481  2347  2228  1979  1916  2234  2138  2277  2182  2318  2314  2165  2168  2372 
 2043  2356  2409  2228  2201  2207  2285  2110  2239  2385  2157  2211  1942  2117  1994  2209  2223  2082  2120  2318  2109  2252  2274 
 1922  2296  2083  2165  2020  2089  2157  2222  2134  2283  2102  2154  1909  2034  2028  2138  2023  2029  2373  2279  2400  2173  2127 
 2195  2020  1932  2220  2083  2185  2162  2204  2230  2118  2264  2239  2091  2050  2160  2125  2127  2156  2066  2343  2199  2233  2339 
 2196  2036  2193  2211  1967  2001  2108  2270  2241  2283  2230  2128  2347  2227  2179  2152  2049  2095  1978  2295  2546  2407  2472 
 2542  2299  2390  2147  2188  2100  1938  2010  2077  2199  2291  2123  2262  2430  2522  2423  2289  2276  2140  2352  2336  2604  2223 
 2249  2256  2224  2235  1967  2079  1934  1932  2210  2162  2156  2086  2201  2433  2315  2357  2294  2289  2145  2393  2376  2490  2309 
 2299  2149  2207  2380  2194  2196  1955  1828  2266  2389  2385  2147  2348  2163  2346  2297  2393  2242  2011  2140  1998  2327  1863 
 2120  1963  2090  2123  2194  2260  2050  2072  2302  2458  2414  2056  2064  2024  1985  2190  2240  2378  2172  2018  2119  2115  2235 


 2096  2416  2376  2397  2455  2232  2201  2259  2212  2298  2327  2448  2544  2503  2458  2231  2340  2203  2328  2314  2513  2613  2532 
 2274  2531  2410  2524  2254  2134  2137  2185  2334  2337  2412  2267  2448  2405  2587  2525  2522  2341  2290  2573  2604  2557  2361 
 2332  2315  2391  2194  2133  1999  2054  2212  2191  2428  2458  2380  2227  2050  2293  2433  2422  2342  2202  2552  2631  2660  2471 
 2357  2423  2497  2323  2103  2084  2102  2337  2319  2738  2704  2380  2257  2125  2292  2275  2464  2264  2480  2658  2403  2760  2485 
 2403  2330  2459  2359  2363  2274  2230  2214  2348  2469  2524  2474  2159  2223  2296  2240  2402  2227  2431  2694  2481  2643  2624 
 2407  2414  2353  2301  2287  2522  2427  2438  2528  2745  2644  2656  2420  2436  2393  2188  2232  2384  2364  2520  2589  2595  2549 
 2376  2309  2284  2245  2208  2547  2540  2413  2203  2553  2500  2526  2480  2306  2200  2204  2401  2558  2411  2548  2560  2529  2565 
 2529  2526  2186  2080  2285  2367  2485  2389  2605  2677  2846  2526  2607  2366  2183  2146  2309  2491  2687  2646  2637  2465  2467 
 2533  2458  2256  2412  2392  2236  2311  2406  2635  2513  2623  2297  2334  2378  2110  2185  2463  2498  2780  2696  2520  2406  2310 
 2764  2527  2367  2684  2428  2367  2430  2477  2819  2750  2421  2586  2421  2304  2457  2457  2601  2333  2522  2683  2554  2007  2332 
 2663  2406  2433  2457  2499  2183  2239  2269  2423  2283  2488  2452  2370  2348  2385  2544  2664  2310  2525  2318  2392  2393  2235 
 2742  2487  2483  2268  2397  2446  2324  2420  2355  2415  2526  2601  2363  2490  2704  2700  2526  2211  2279  2228  2438  2521  2444 
 2483  2255  2392  2283  2288  2249  2085  2247  2246  2413  2517  2462  2327  2289  2580  2552  2610  2449  2453  2315  2349  2292  2466 
 2612  2465  2460  2474  2405  2243  2306  2363  2460  2697  2549  2529  2106  2349  2384  2551  2442  2225  2487  2520  2374  2306  2356 
 2231  2349  2449  2591  2442  2344  2377  2356  2397  2819  2624  2445  2140  2224  2495  2375  2532  2405  2377  2455  2455  2410  2501 
 2238  2407  2494  2569  2417  2325  2480  2365  2334  2506  2443  2409  2040  2322  2343  2407  2358  2302  2285  2578  2351  2495  2472 
 2197  2404  2357  2478  2170  2241  2300  2471  2425  2395  2411  2334  2395  2180  2192  2380  2358  2399  2478  2573  2611  2503  2268 
 2346  2219  2243  2472  2345  2491  2435  2412  2433  2310  2580  2374  2432  2411  2276  2356  2249  2250  2367  2566  2406  2596  2503 
 2459  2354  2354  2524  2213  2257  2252  2330  2539  2450  2556  2384  2501  2434  2494  2467  2312  2238  2306  2501  2696  2638  2724 
 2576  2546  2592  2555  2343  2379  2227  2210  2162  2416  2561  2254  2616  2482  2748  2562  2472  2521  2337  2572  2603  2819  2476 
 2409  2290  2412  2313  2242  2221  2174  2249  2295  2323  2611  2171  2424  2740  2524  2566  2457  2698  2466  2526  2509  2783  2492 
 2495  2282  2322  2635  2537  2391  2176  2107  2324  2492  2676  2529  2497  2439  2512  2472  2614  2476  2221  2319  2124  2556  2134 
 2277  2015  2235  2245  2449  2285  2286  2453  2549  2659  2573  2305  2421  2221  2223  2351  2413  2547  2469  2222  2188  2403  2365 


 1928  1948  1908  1928  1882  1902  1833  1843  1926  1884  2015  1861  2159  2024  1950  1824  1900  2000  1817  2131  2129  2232  1945 
 1955  2008  1981  1937  1670  1747  1706  1806  1829  1854  1984  1794  1998  2019  1950  1965  1994  1766  1846  1924  2130  2033  2005 
 1816  1982  1973  1857  1799  1639  1646  1801  1789  1898  2020  1904  1779  1603  1899  1893  1932  1810  1826  2119  1992  2093  1972 
 1904  2024  2073  1958  1867  1610  1602  1939  1968  2088  2121  1972  1778  1719  1823  1879  1982  1730  2050  2038  2081  2089  2054 
 1992  2032  2006  1914  2021  1818  1955  1831  1796  2106  2003  2085  1973  1952  1779  1898  1846  1741  1851  2115  2096  2125  2001 
 2080  2040  1974  1934  1858  1904  1883  2122  1960  2166  2000  2005  1937  1968  1729  1870  1755  1871  1830  1978  2063  2178  2175 
 2022  1972  1781  1752  1938  2053  1973  1949  1901  2071  2103  2026  1924  1892  1954  1815  1970  2023  2051  2110  1994  2132  2116 
 2042  2016  1828  1716  1757  1912  1886  1960  2187  2207  2378  2150  2197  1885  1800  1629  1884  1944  2179  2222  2173  1947  1923 
 2202  1983  1907  1926  1912  1890  2018  1836  2104  2126  2018  1864  1889  1857  1878  1929  1993  1868  2062  2208  2307  1822  1875 
 2080  2007  2025  2050  2021  1868  1907  2024  2200  2052  2007  2041  2015  1934  1920  1832  1981  1985  2006  2107  2022  1866  1815 
 2036  1968  1968  1935  1865  1942  1949  1930  1986  2046  1977  1953  1730  1910  1967  2184  2123  1920  1867  1646  1973  1913  1952 
 2183  2059  1893  1904  1974  1812  1879  1922  1953  1932  2072  2101  1893  2039  2247  2232  2065  1952  2053  1693  1852  1851  2033 
 2048  1846  1875  1855  1830  1738  1713  1808  1953  2068  2115  1881  1728  1869  2176  2242  2073  1918  1900  1996  1960  1954  1993 
 2139  2047  2088  1907  1935  1769  1845  1962  1982  2277  2286  2106  1739  1638  2067  2042  1926  2016  2009  2064  1913  1933  1952 
 1866  2041  2126  2043  1875  1876  1991  1956  1900  2309  2105  2087  1802  1762  1954  2115  2084  1944  2144  2089  1968  1931  2109 
 1823  2047  2059  2111  2043  2073  1998  1853  1873  2140  1938  1904  1715  1821  1924  1881  1958  1922  1853  1865  2026  1943  2013 
 1827  1849  1958  1990  1701  1840  2065  2114  1911  1964  2019  1830  1720  1790  1850  1742  1943  2039  2051  2164  1991  1988  1960 
 1866  1901  1852  1879  1768  1892  2056  2017  1937  2001  1958  1973  2077  1870  1852  1899  1908  1729  1845  2038  2163  2039  2055 
 2042  1821  2025  1907  1846  1896  1797  1989  1951  1907  2035  2041  1960  1954  2011  2021  1809  1758  1890  1937  2192  2172  2169 
 2199  1973  2005  2079  1793  1871  1820  1766  1969  1981  1984  1870  1915  2209  2366  2089  1944  2079  1985  2078  2164  2285  2096 
 2200  2024  1947  2071  1798  1841  1671  1793  1899  2015  1836  1766  2096  2129  2264  2170  2071  2148  2017  2107  2073  2238  1988 
 2044  1872  1934  1964  1944  1923  1656  1845  1915  2230  2158  1866  1932  1915  2107  2074  2076  1981  1809  1933  1835  1960  1854 
 1781  1742  1841  1962  1965  1943  1824  1894  1988  2201  2166  1908  1857  1759  1773  2028  2042  2180  1862  1785  1799  1853  1913 


