 1851  2038  1852  1852  1788  1853  1768  2061  1929  1739  1999  1881  1832  1770  1663  1855  1831  1863 
 1970  2035  1928  1747  1751  2018  1985  1914  1974  1701  1809  1949  1882  1894  1717  1891  1819  1869 
 1959  1858  1961  2106  2002  1850  1945  2066  1954  1693  1693  1753  1799  1826  1915  1899  1868  1832 
 1742  1682  1833  1863  1921  2112  2280  2172  2030  1857  1794  1768  1726  1806  1905  1920  1860  1787 
 1778  1911  1786  1951  2071  2124  2231  2016  1839  1840  1598  1690  1694  1788  1780  1951  1800  2018 
 1667  1678  1705  1763  2118  2138  2194  2035  1898  1890  1740  1579  1717  1862  1825  1727  1870  1901 
 1769  1842  1909  1842  2144  1947  1971  2026  1948  1860  1869  1861  1549  1738  1682  1926  1918  1946 
 1808  1801  1936  2008  1792  2001  1840  1950  2036  1905  1718  1781  1697  1737  1724  2023  1895  1890 
 1968  1829  1986  2009  1897  1707  1950  1994  2008  1847  1731  1561  1941  2024  2056  1924  1888  1870 
 1821  1703  1726  1870  1856  1731  1726  2172  2004  1812  1645  1620  1858  1890  2243  2012  1877  1704 
 1884  1771  1818  1867  1770  1785  1723  1909  2014  1829  1768  1924  1980  2044  1955  2073  2008  1681 
 2047  1942  1923  1938  1902  1860  1923  2007  2097  2008  1892  1795  2004  2032  1852  2037  1886  1709 
 1912  1925  1962  1791  1717  1953  2018  1989  1989  1950  1945  1875  1990  2057  2126  1946  1974  1733 
 2034  2020  2006  1784  1889  1994  1957  1886  1911  1820  1952  1746  1784  1987  1881  1844  1780  1758 
 1823  1841  1878  1715  1742  1838  1747  1723  1728  1976  1906  1838  1792  1875  1931  1775  1729  1881 
 2041  2068  2179  2087  1923  1870  1869  1691  1813  1885  1888  1715  1811  1983  1834  1891  1768  1884 
 1895  1985  2193  2051  1784  1689  1821  1829  1809  1807  1780  1686  1746  2000  1963  1819  1695  1811 
 1912  2050  1997  2045  2098  1738  1689  1825  1989  1689  1602  1582  1729  1748  1946  1721  1756  1812 


 2468  2525  2327  2370  2371  2545  2581  2456  2561  2370  2249  2505  2247  2279  2171  2231  2295  2401 
 2515  2572  2571  2570  2424  2426  2571  2600  2575  2471  2327  2503  2464  2341  2292  2457  2336  2321 
 2495  2670  2590  2712  2587  2527  2575  2697  2529  2467  2415  2393  2382  2330  2231  2611  2372  2387 
 2401  2456  2362  2441  2689  2767  2841  2697  2441  2410  2209  2138  2200  2317  2470  2614  2360  2412 
 2304  2262  2582  2482  2712  2718  2736  2684  2358  2357  2176  2294  2058  2404  2452  2444  2430  2591 
 2132  2064  2365  2225  2719  2811  2825  2604  2628  2277  2303  2333  2146  2455  2250  2532  2383  2575 
 2416  2411  2625  2534  2474  2663  2582  2556  2572  2496  2346  2242  2216  2229  2180  2514  2421  2621 
 2303  2320  2317  2507  2518  2493  2531  2497  2598  2473  2284  2069  2140  2217  2347  2495  2477  2487 
 2359  2318  2402  2521  2467  2343  2446  2551  2670  2436  2143  2225  2276  2397  2676  2707  2529  2489 
 2280  2143  2361  2467  2247  2390  2222  2626  2860  2367  2195  2043  2364  2635  2630  2556  2457  2418 
 2442  2297  2351  2327  2369  2244  2282  2489  2693  2331  2439  2078  2675  2606  2747  2767  2549  2133 
 2478  2550  2552  2497  2347  2570  2481  2633  2656  2388  2438  2543  2605  2538  2586  2526  2429  2298 
 2655  2661  2576  2411  2386  2492  2417  2550  2466  2336  2507  2533  2635  2659  2581  2479  2384  2457 
 2644  2659  2487  2343  2296  2563  2634  2419  2498  2542  2353  2343  2311  2473  2509  2495  2371  2555 
 2303  2451  2516  2337  2171  2253  2234  2212  2560  2540  2498  2385  2376  2469  2539  2398  2328  2357 
 2530  2638  2787  2537  2508  2375  2236  2165  2228  2403  2441  2314  2278  2627  2490  2441  2306  2536 
 2396  2674  2711  2558  2498  2150  2246  2468  2389  2446  2216  2296  2410  2500  2470  2271  2025  2388 
 2535  2533  2783  2711  2583  2225  2293  2408  2251  2369  1922  2086  2294  2375  2477  2293  2366  2515 


 2416  2229  2333  2209  2070  2242  2224  2291  2242  2150  2151  2167  2101  1959  1907  2169  2044  2291 
 2287  2410  2376  2076  2356  2154  2253  2434  2201  2066  2112  2154  2192  2114  2099  2144  2042  2092 
 2290  2392  2281  2352  2302  2159  2266  2304  2292  2036  2052  2225  2016  2114  2006  2083  2266  2151 
 2165  2092  2133  2218  2451  2317  2404  2386  2152  2148  1958  2067  1976  2088  2140  2304  2166  2110 
 2088  2153  2257  2153  2410  2479  2634  2338  2210  2102  2106  1967  2013  2191  2154  2316  2201  2248 
 2039  1882  2145  2182  2393  2438  2556  2244  2160  2115  2134  1860  1918  2188  2000  2118  2128  2231 
 2034  2166  2273  2329  2391  2257  2338  2179  2285  2095  2133  2001  1929  1994  1925  2157  2135  2396 
 2007  2096  2098  2320  2182  2313  2183  2308  2352  2204  2057  1853  2024  1983  2262  2367  2314  2322 
 2149  2183  2169  2229  2142  2108  2208  2335  2334  2115  2007  1852  2119  2349  2284  2553  2289  2164 
 2114  1931  2112  2287  2126  2144  1936  2491  2385  2253  1837  1914  2096  2454  2375  2441  2277  2046 
 2006  1994  2012  2247  2219  2098  2015  2239  2459  2115  2041  2087  2361  2327  2380  2472  2059  2109 
 2304  2361  2134  2345  2266  2188  2196  2408  2286  2250  2182  2176  2338  2383  2141  2256  2117  1900 
 2517  2359  2335  2188  2080  2260  2322  2188  2286  2123  2271  2254  2275  2456  2286  2271  2191  2132 
 2301  2351  2297  2222  2115  2373  2333  2200  2400  2237  2323  2145  2172  2205  2236  2165  2206  2208 
 2316  2094  2279  2107  1914  2194  2098  1978  2069  2285  2385  2061  2139  2327  2297  2181  2178  2253 
 2200  2315  2522  2182  2308  1902  2093  1887  2016  2232  2304  2037  2030  2239  2300  2121  2151  2192 
 2291  2344  2536  2432  2086  1908  2091  2252  2090  2211  1870  2046  2183  2128  2297  2029  2064  2096 
 2321  2209  2475  2465  2267  2029  2103  2161  2125  2026  1973  1751  2087  2173  2292  2108  2160  2011 


 2090  2030  2044  1890  2091  2028  1963  2120  2145  1971  1856  1999  1968  1820  1839  1904  1711  1854 
 1971  2021  2122  1966  1994  1950  2183  2063  2267  1992  1834  2008  2045  1954  1847  1924  1900  1905 
 1985  1981  2188  2149  2123  2082  2097  2244  2123  2020  1791  1940  1806  1813  1935  1998  1882  1866 
 1821  1872  1869  2143  2111  2162  2168  2163  2047  1840  1749  1727  1698  1856  1995  2122  1883  1989 
 1811  1965  1777  2065  2171  2259  2263  2186  2060  2010  1767  1895  1774  2008  2008  1997  1933  1926 
 1820  1962  1833  1928  2050  2204  2328  2133  2031  1938  1935  1941  1647  1919  1961  1974  1823  2093 
 1858  2022  2051  1910  2100  2188  2140  1943  2120  1944  1863  1911  1608  1705  1778  2119  1923  2213 
 1824  1726  1838  1908  1962  2072  2079  1997  2000  1962  1820  1677  1756  1726  1881  2154  2096  1986 
 1724  1827  1935  2049  1921  1835  1829  2030  2146  2004  1722  1663  1816  1999  2057  2088  2119  2040 
 1796  1837  1811  1993  1812  1830  1822  2063  2333  1933  1708  1625  1683  1976  2158  2256  2067  1920 
 1933  1903  1798  1774  1844  1726  1894  1898  2194  1908  1929  1813  2099  2146  2380  2143  2040  1800 
 2143  2205  2035  1835  1914  1919  1949  2071  2199  1954  2019  1989  2185  2050  1972  2129  2056  1842 
 2081  2162  1943  1875  1870  1842  2023  2056  2035  1924  2034  1890  2053  2059  2060  2050  2016  1981 
 2057  2140  2038  1839  1823  2035  1973  2013  1982  2082  1990  1793  1878  2034  1981  2004  1838  2024 
 1906  1904  2079  1727  1843  1788  1822  1825  1954  1942  2119  1831  2014  1990  2107  1884  1838  1974 
 2006  2132  2284  2049  1930  1795  1859  1747  1830  1985  1961  1818  1950  2048  2038  1939  1816  1946 
 2099  2133  2334  2189  1963  1666  1818  1951  1905  1826  1824  1762  1891  2169  2067  1749  1663  1988 
 2034  2105  2123  2184  2046  1952  1930  1888  1774  1986  1533  1721  1833  1989  2052  1940  1871  2013 


 2371  2368  2189  2104  2347  2171  2301  2395  2410  2221  2185  2196  2115  2068  1895  2145  2091  2320 
 2198  2265  2455  2189  2137  2219  2239  2371  2236  2113  2142  2163  2346  2073  2108  2219  2114  1944 
 2143  2440  2378  2259  2338  2194  2405  2314  2192  2004  2051  2323  2059  2039  1935  2289  2172  2244 
 2051  2047  2135  2115  2308  2541  2558  2546  2325  2063  1963  1996  1955  2111  2408  2255  2261  2097 
 2075  2051  2229  2298  2473  2368  2457  2421  2283  2218  2092  2062  1905  2287  2061  2160  2000  2379 
 1996  2105  1983  2255  2401  2566  2624  2262  2387  2098  2107  2070  1838  2051  2024  2133  2005  2286 
 2122  2233  2301  2123  2270  2309  2448  2200  2162  2326  2046  2083  2057  2096  2142  2358  2268  2320 
 2127  2080  2268  2276  2248  2320  2160  2340  2313  2284  2155  1871  1995  2012  2062  2328  2307  2333 
 2003  2157  2066  2368  2247  2134  2055  2355  2451  2067  1919  1988  1986  2284  2328  2407  2299  2207 
 2031  1996  2207  2101  2080  2078  2009  2400  2544  2166  1900  1761  2308  2333  2318  2341  2124  1956 
 2310  2141  2264  2224  2003  1961  2101  2283  2334  2182  2037  2037  2383  2284  2469  2500  2267  1925 
 2252  2344  2183  2176  2049  2256  2222  2339  2520  2176  2229  2357  2357  2402  2399  2345  2201  2125 
 2425  2515  2299  2274  2083  2176  2150  2371  2417  2345  2187  2238  2307  2353  2194  2229  2209  1945 
 2371  2160  2268  2080  2261  2179  2336  2094  2348  2208  2322  2036  2083  2281  2287  2291  2253  2215 
 2111  2302  2103  2074  2008  2150  1974  2067  2220  2261  2419  2021  2167  2196  2238  2136  1994  1961 
 2169  2178  2689  2135  2166  2136  2226  1970  1992  2242  2112  2152  2065  2317  2150  2043  2117  2225 
 2317  2360  2503  2443  2217  1986  2138  2206  2111  2147  1923  1865  2231  2489  2393  2080  1979  2234 
 2465  2437  2504  2476  2214  2100  2072  2171  2149  2043  1849  2001  2034  2226  2334  2011  2175  2150 


