  658   668   665   639   669   684   674   720   717   748   723   691   650   718   692   678   648   645   684   673   687   674 
  613   631   667   659   616   686   637   705   684   724   675   696   709   661   644   646   647   660   724   717   686   650 
  585   635   665   673   683   666   659   672   670   710   659   695   677   681   656   641   675   712   715   704   691   641 
  627   663   715   704   676   707   645   682   699   718   657   662   712   698   689   643   692   709   748   718   720   664 
  718   703   734   709   706   691   690   678   696   695   729   675   716   685   725   681   657   694   725   767   745   702 
  782   780   765   705   635   636   695   721   720   688   685   680   692   686   735   693   695   667   688   711   695   633 
  735   749   729   696   677   703   697   698   688   703   726   713   718   673   694   702   693   718   665   702   667   644 
  745   725   724   705   709   678   680   689   698   700   710   708   727   675   673   686   686   656   674   702   652   650 
  677   671   736   707   699   638   643   631   665   655   751   722   696   662   679   726   688   653   666   737   689   727 
  688   715   707   676   656   597   598   625   718   717   730   709   695   699   699   731   674   645   591   650   660   721 
  739   722   714   638   584   587   597   649   686   755   717   670   645   637   705   739   663   700   667   673   671   709 
  707   714   673   669   651   648   585   614   670   705   724   700   668   688   629   655   699   697   710   714   667   695 
  745   689   674   673   651   639   654   608   677   706   705   718   679   681   654   623   661   761   761   739   738   715 
  722   721   709   733   726   713   658   685   714   731   757   720   733   740   664   676   668   705   755   779   705   777 
  673   642   700   740   729   711   739   703   766   779   686   678   646   717   762   731   700   744   751   822   800   784 
  665   647   689   741   781   738   761   737   740   678   667   615   558   693   705   739   684   683   732   768   716   738 
  632   648   680   723   747   707   703   723   674   647   595   593   564   639   768   786   746   720   710   720   709   718 
  703   708   738   748   730   676   728   734   732   710   649   676   619   669   680   702   707   710   707   681   665   685 
  714   688   717   716   689   663   717   687   710   714   710   777   738   728   664   617   696   679   696   688   687   653 
  743   695   735   676   677   681   706   706   715   711   727   769   740   717   651   628   624   661   708   745   718   710 
  732   690   714   661   693   651   663   711   675   662   703   754   714   753   719   721   647   708   752   767   718   726 
  735   722   715   708   706   691   691   681   656   681   693   715   702   748   740   742   708   707   721   714   723   671 


  667   684   691   652   690   703   700   725   737   726   727   685   694   688   652   663   672   691   709   688   655   699 
  668   705   688   678   696   655   649   692   686   720   701   662   670   671   661   666   650   701   745   692   693   639 
  603   616   669   665   702   731   663   669   691   693   691   689   727   673   692   695   714   714   722   714   692   592 
  620   670   710   741   721   664   680   737   694   720   671   678   709   720   681   645   689   700   706   746   742   656 
  697   734   741   712   709   755   715   720   712   734   748   712   724   715   688   696   682   703   750   744   755   700 
  796   800   769   694   678   649   701   693   704   699   710   710   705   714   720   710   663   651   701   705   682   649 
  758   761   724   709   670   673   715   656   674   719   769   733   711   699   758   690   737   658   713   713   649   693 
  724   726   761   759   725   635   655   662   712   756   779   731   701   696   703   672   704   679   676   690   642   655 
  747   672   723   723   684   647   665   613   701   729   739   744   675   650   715   742   663   686   672   703   681   715 
  672   705   734   670   656   606   641   654   706   724   748   688   686   710   714   735   702   650   635   668   677   694 
  692   713   704   623   599   566   603   625   674   761   724   689   681   680   670   733   697   729   629   674   689   719 
  733   704   722   640   662   639   636   605   671   722   694   721   678   716   644   698   656   709   662   706   646   731 
  758   745   720   696   668   628   603   650   711   736   723   733   677   729   644   648   689   774   751   776   734   757 
  704   701   746   719   741   699   694   637   704   762   739   746   701   755   720   661   643   733   784   811   737   750 
  639   632   683   689   793   737   726   688   733   753   711   686   685   691   734   690   680   722   812   797   784   819 
  686   651   692   725   763   732   749   729   687   716   649   624   621   721   745   746   664   692   701   796   753   759 
  685   658   676   738   774   738   738   728   675   667   631   584   561   694   716   762   761   743   732   720   715   752 
  728   769   777   764   729   702   709   736   725   711   652   683   658   681   696   736   736   687   689   693   671   665 
  737   732   728   705   680   687   680   688   747   701   717   784   720   742   711   696   712   717   731   691   721   717 
  755   683   734   672   677   641   689   710   708   743   748   793   793   772   677   632   643   665   712   748   718   672 
  737   672   730   678   673   654   724   737   721   695   681   764   747   814   760   708   689   742   759   725   738   696 
  758   750   728   696   700   742   689   734   685   717   731   773   757   757   751   752   693   709   681   718   692   730 


  658   628   617   645   619   637   682   680   664   705   668   630   636   636   632   598   642   637   651   631   636   636 
  619   618   619   632   636   620   584   663   642   679   641   651   644   633   627   643   639   625   689   645   632   597 
  549   575   612   622   646   635   592   647   648   632   642   640   662   637   650   645   633   659   694   676   630   596 
  579   622   646   712   660   640   659   670   676   659   650   623   692   685   627   600   681   662   676   676   687   626 
  669   696   704   634   670   706   657   657   666   668   663   637   677   647   656   658   631   654   674   699   668   648 
  734   747   756   664   602   607   652   635   662   640   676   639   652   643   699   664   609   621   621   670   629   606 
  742   688   689   669   586   634   663   636   643   676   692   653   657   666   695   657   672   651   642   659   603   605 
  709   690   723   686   650   611   640   627   671   676   710   688   692   654   617   649   627   636   616   657   608   609 
  657   662   674   657   650   591   590   607   655   677   694   668   678   636   635   694   623   599   618   649   643   658 
  635   651   677   634   601   556   596   612   652   675   708   656   649   657   706   667   584   600   585   615   621   673 
  682   676   633   589   571   560   554   586   641   708   663   662   646   643   649   674   656   633   596   614   635   664 
  653   682   641   647   612   610   564   599   673   679   684   677   654   670   599   610   630   656   649   637   615   652 
  709   691   637   663   641   578   595   583   633   687   661   690   633   642   602   626   654   699   711   743   706   686 
  637   649   663   668   706   681   677   607   659   705   682   689   673   710   669   588   609   715   705   726   703   707 
  591   619   631   677   738   675   682   676   697   707   649   648   622   686   672   658   636   702   716   749   740   748 
  628   589   648   706   713   691   717   650   649   649   626   618   553   667   657   689   615   650   677   720   745   727 
  636   616   664   686   682   655   695   718   613   595   533   533   528   615   690   707   685   665   673   642   654   681 
  685   694   715   718   673   629   692   689   685   661   633   644   597   594   677   673   714   690   671   637   606   669 
  710   668   711   640   643   631   656   633   713   665   687   734   687   673   626   638   678   678   677   650   618   648 
  702   648   689   616   636   627   652   658   648   676   684   746   738   692   628   599   571   656   669   684   690   639 
  685   666   666   611   636   618   639   694   644   636   665   705   729   727   676   666   637   668   692   662   697   665 
  698   743   657   655   665   654   678   660   630   646   686   693   717   699   696   692   687   665   677   653   675   646 


  577   549   586   536   561   611   599   603   628   676   614   617   552   616   595   584   618   589   593   589   624   573 
  528   555   589   599   577   552   549   607   637   652   617   577   599   629   608   578   581   606   625   624   566   562 
  539   535   583   580   578   609   571   563   633   599   589   601   635   576   559   581   600   614   647   614   590   556 
  558   596   611   635   624   614   580   618   639   579   589   568   621   567   592   595   628   625   620   610   649   566 
  648   630   640   629   642   614   611   642   584   635   640   617   634   582   654   597   576   630   593   689   621   609 
  653   674   652   604   582   558   592   636   619   591   617   589   595   625   591   595   597   575   617   627   612   550 
  632   677   650   607   582   604   636   600   575   629   649   608   633   595   620   642   585   611   608   607   580   590 
  662   619   654   629   640   559   592   582   659   640   643   606   636   620   635   615   617   560   567   610   563   597 
  598   614   629   638   596   551   527   519   573   628   673   634   599   590   630   625   582   591   570   562   576   621 
  608   597   623   595   568   529   535   564   661   652   644   625   597   585   638   662   584   536   518   604   600   579 
  611   649   628   565   542   498   514   550   596   641   629   622   593   605   646   600   599   610   593   581   594   594 
  609   660   611   593   533   575   565   567   567   602   611   593   612   633   548   616   594   612   589   603   588   630 
  678   631   633   575   607   581   552   532   609   647   591   633   590   635   526   566   587   683   669   671   637   630 
  610   620   625   670   682   593   593   563   618   642   700   660   582   648   598   613   616   623   652   686   632   651 
  587   573   572   625   660   605   668   627   655   684   619   611   561   648   648   604   595   642   694   713   689   694 
  585   584   615   641   660   635   660   645   625   597   535   549   510   641   619   639   571   581   641   690   645   631 
  572   572   595   632   664   640   624   621   599   599   499   551   501   560   692   699   632   660   628   620   630   655 
  640   623   666   640   651   595   638   628   637   627   589   573   572   626   603   589   619   615   607   622   565   608 
  607   634   659   612   612   575   587   615   627   635   608   684   640   636   586   544   611   615   628   640   621   629 
  641   620   643   604   611   599   621   597   607   605   636   685   672   616   555   574   560   584   619   625   624   599 
  644   613   616   560   590   591   599   626   623   583   609   674   664   654   636   620   603   612   636   637   678   606 
  641   622   584   614   598   613   638   634   594   599   662   629   631   652   690   644   624   604   645   608   594   599 


  637   664   674   618   653   720   695   710   706   743   711   695   682   711   690   661   653   669   687   664   665   697 
  608   643   675   656   652   626   647   677   687   715   690   642   690   714   657   649   635   664   718   718   687   622 
  560   615   669   639   645   684   660   646   686   696   688   673   693   687   680   664   685   719   727   686   664   611 
  624   666   713   695   704   693   660   715   702   680   675   628   728   704   690   673   675   698   687   729   735   643 
  700   709   726   703   682   712   697   721   691   672   716   671   693   684   717   686   670   705   710   755   737   692 
  788   765   773   706   636   635   686   719   698   689   704   660   681   716   683   680   682   680   703   726   680   608 
  742   740   692   686   645   660   727   677   670   697   712   705   727   683   711   701   725   679   694   704   652   638 
  705   728   706   716   723   631   650   700   694   714   746   705   724   694   689   684   695   653   666   675   650   654 
  703   686   692   735   645   609   639   604   676   715   711   736   693   639   702   731   669   653   644   675   668   684 
  657   707   697   684   655   616   590   639   705   739   746   683   661   664   705   724   666   615   612   642   640   669 
  710   711   685   646   575   565   563   635   693   746   745   682   639   660   687   701   692   676   646   644   691   681 
  691   701   692   628   639   646   621   618   667   708   696   703   664   671   649   677   653   672   688   684   674   671 
  753   722   682   671   659   640   588   620   709   721   703   698   661   714   602   646   685   757   741   734   750   739 
  677   692   712   703   724   710   668   640   712   752   745   735   675   737   681   690   660   729   743   763   759   730 
  670   617   657   718   757   708   727   686   727   751   730   674   643   690   688   709   678   716   795   805   781   774 
  668   655   693   704   737   722   726   720   690   686   637   593   595   671   703   746   642   655   686   776   741   729 
  657   657   657   723   729   723   703   702   660   621   600   555   519   638   761   768   702   715   705   708   685   735 
  723   728   737   723   735   688   696   720   721   705   665   651   638   659   695   704   720   690   683   663   671   670 
  706   708   698   710   676   672   682   681   720   713   693   766   732   727   707   647   703   695   708   663   749   724 
  727   731   698   652   672   644   664   684   696   714   747   777   768   725   636   624   649   648   701   713   729   647 
  716   665   670   675   674   624   668   692   706   652   669   775   742   767   748   689   683   726   765   723   747   691 
  736   721   701   670   673   708   696   681   638   679   723   724   700   751   758   737   672   695   700   698   676   682 


