    9   218   144    57   184   163    38    47    80   116    32   138    88     5   139   231   106    36   179    86 
    4   136   232    99   169   185   192   177    98   183   222    54   156   140   147    75   146   112   153   147 
   42   199   179    56    94    20    15   184   166   246    82   117    57    93   223   131   243    63    77   179 
  105   217   160   199    65   145   157   173   189     1    46   222    51    81    16    76    62    66    26   136 
  120   225   122    39   197   250    34     2   159    44    16   127   170    43   228    47    45    57   180    27 
  124   110    94   188   223    80   221    77   155   166    22   218   103    98   168    14    76   146    35   135 
  149   240   182    98    68    26   243   202   201     8    57     3     1    52   130    84   104   113   102   122 
  183   196   106   111   198   109    23   104    59   117    22    20   131   102   147    49    18    52   182    45 
   36   233   117     1     3    58   134   207    83   119   142   185   209    31   216    90   230   178     7   117 
  211    77   204    39    84   231   219   153   168    54    26   107    82   200   210   188    60   133   154   234 
  212    74   215   153   133   178   213    63    68   167    20    36   177   195   167    67   209    57   225    39 
  207   173   213   101    33     3   180   187    37   105    25    34   147   151   176    57   212   212    41   124 
    2    78   166   213    79    13    96   196   157    95   184   224    49    72   149    14   207   167   171    26 
  143    49    25    85    68   203   145   169   212   170    43   179   137    90    87   224   190   140   109    55 
  219   128    46   201   219     1   166   231    83   180   194   143   170    89   198   163   219   219   134   192 
  131   239   191    49    42   107    75   139   118   146   232   157   138   201   170   219    53    60   168   178 
  127    16   129   101     2   175    32    83     9    64   223    34   194   180   107   147    84     3    57   121 
   92   220   122    80     7   123    42   156   153     7    97    42   246   169     4   172   242   220   148    55 
   33   243   209   185   243   195    55   103    94   113    24   125   172    54   115   218   154    47    55    90 
   45    42   228   114    79    88    70     1    85   163    82   219   109    28   138   168   183   181   219   187 


   56   161   112    57     9   210   215   137    33   175   239   174   194    85   217    43    25    84   241    86 
  103   126   175   156   175   218   171    69   107   106    60   145   227    23    89   141   148   236    39   111 
   99   229   213   209   189   157    27     4   160   208    30    89   153    76   233   150   167   197   203    65 
   68   189    77   153    58    80    75    54   193   155    21   161   236   247    25   199   230    31     5    92 
  134   155    89   236   165   165   208    55   159   131   148   181   193   114    46    56   216    58   113   192 
  247   222   224    41   185    70   159   175   219   211    65   169    81   186    65     4    79    49   233    32 
    9    14   118   241   206    14    40   187   240    38   153   242   198    67   235   201   239    10   192   203 
   68    75    62    44    28    39    93    45   178   121   183    23    44   183    71    13   182   243     9    98 
  133     5   107   205    66   212    37    55   191   179   126    45   101    83    64    27   184   191   250   192 
  218   163    47   115    58   243     3   129    79     7    91    34   135    61    31   164   126   151    80   179 
  205    56   163   183    84   113   157   153   135    55   164    22   219   160    90   158    93   207   213    89 
    5    18    57   235    75   142   250   179   171   163   187   157   129   166   131   169    99   222     2   133 
   27    61   179   204     3    17   157   152   103   173    13   228   180   181    95   240   157   171     5    14 
  186    47    99   105   163   110   222   243   159   246   123     1    46   214    64   213   176   229    49    60 
   72     9     7    66   155   211    94   228    54   210   121   161   183   248    62    88   114   201   210   115 
  233   167   233   239   119    49   206   173    32   226    64   139   111   227   170    63   243   153   119    34 
  149   119    31    30    33   197     7   157   109   145   184    98   139    55    75   202   192   103    30    44 
  174   165   107   193   186   160   245    52   234   161   199    51   147   239   143    48   125   118    70   168 
  215    34    59   146    47   147   121    78    79   191    71   154   223    68   237   158   164   116   217    75 
  190   225   197   128   200   106   206   128   158    34    82   160    78   244   148   181   197    60    63   162 


   96    66   100   229   214   103   222    70    27   126   236    55   151   191    88    54   141    80   171   202 
  164    93   249   102   128     7   133   229   235    62    66   217   158     5   172   189    14   166   249    91 
   66   229   179    21    61   172    80     2    47    74     4   250   187   136     6    22   215   165    86   151 
  138   109   194   211   169   132    64    23    23   151    62   197   248    13    18   174    48   182   186   210 
  103     5   107     5    53   139    10   130    90   234   127    16    73   160   160     6   176    14   223   222 
   72   220   231    32   126   210   150   191     1    43   199   214   182    14   213    97   157   116    59    21 
   24    60   134   148    11    39   149   118    92   172    85   144   124    65   220   191   170    56   227   209 
   83   231   185   132    56   193    26   115    20   109   231   119   236    26   217   189    63   160   133    31 
  113    49   147    60    51    93     6     9    36    16   236   182   123     2    71   217    60   245    42   108 
  141    98   157   224    37   232   135    89   164    86   247    73   150    39   146    39   166     1   141    89 
  236   248   222   160    12   194   186    59    19    70   231   220   120   110    61   239   121    73   208    25 
  117   230    32   221   215   213    95   121    58    79    44    46   144   166   249   228   172   231   233   183 
   84   178    41   194    48   115   125   131   176   178   199    73    37    29   245    70   218    25   215   221 
   57    76    36   201   199   221   199    28   118    79   157   155    68   241   234   212    89    67   225    32 
  132   236   171   196   194   195    47    30    93    32    26   132    58   160    40   130    93    39   199   105 
   89   154    81   221   121   244   185    81   174     6   108    83   176    15    74   226   244   105   100    44 
   14    61   160   230   113    61    39   165    43   224    49   220    30   152    84    65     8    35    77    20 
   60   185    60   219   250   197   226   192   147    72   209    71   224   199   250   102   188   166    65   183 
   13   182    84    46     2   103   112   140   237    75   192   152   156    64   133   155   175   145   112    39 
  138   221   218   248   169   104   245    32    14   170    44   232    51   156   201    57   243    49   160   197 


  141   116   193    22    11    93   208   203    71   143   201     9   202    29    22    31   232   109   249    17 
  134   173    35   248   152    27   186   220    18    72   181   190   217   172   174   219    97     3   106   193 
   34    98   167    83   118   243    36    56   182   228    75    56   186   210    76   161    64   132   100    53 
   96   220    89   155   242   227   239    85   200     8    85   167   137   242   238    65   165   116    61   138 
  180    51    47   149   108   101   193   243   201   239   171   248   103    13   217    66    48   230   118   134 
  172     5   133    43   136   150     5   198   132    37   168   113    75    28    79   104    29   149    76   119 
   23   139   169   202   128   242    34   130   195   186   157   141    24   209    71    51   199   236    47    23 
  233   217   222   118   137   196   232   147   147   244   200   175   142    28    72   171    12    58    79    52 
  126    80    67   197   235    70    84   131   186   247   110    37    29   137    93   219   187   127     3   158 
  120   243   133   197    70   131   210   134   245   103   133   171   103   145    50   109     9   177   113     2 
  227    94     3   158    45   167   121   108   160    78   101   157   201   179    43    63   229    98   105   194 
  232    22    44   116    90    27   224    90   146   111   172    54   226   230    56    30   137   170   120    55 
  154    82    81   177    13   160   198     7   181   197   175    20   227   100   128    22    23    14    43   210 
   99   167    66   176   139     6   145   208    21    61   139   117   100    61   229   241    93   240    71    91 
    8    26   215   206    71    25    77   205   182    54    95    91    43   191   173   175     5   198    27    63 
   98    24   208   142    20   206   190   221   175   179   236    25    40   192    40   170   195    69    40    83 
  221    90   225   145   152    91   223    54   174    89   200   235   148    24   227     3   182   176   219   178 
  188   198   189    65   199    79   174   226   106   233   116    17    63   174     2    60    40   142    33   100 
  171   221   158   230   105   223   196    71   108    32   230   248   157   186   106   175    83    69   146   229 
  180    12   116   229    26   201   161     6    69    40   233   149    77   119   223    69   103   216    97     9 


  127    90   188   210   237    56    61    19   120    57   147    98    44    97    60    68   139    43    50     9 
  114   138    83    63   228    21    13   203   132   240   171     6   171    34   159   137    96   192   174    77 
  183   114   131    95   187   118   212    86   113   201   246   203    77   119    13    43   200    27     6    64 
   25    74   196    72   161   171   218    88   211   222    98   184     7   191   213    20   230    49    68   150 
  234   122   170   185     4   116   234    59   227   212   156    18   197   202    68   165    77    13   124   227 
  170   124   170   214   195    70   110    38   186     5   200   162   133   217    32    61    93   111   138   174 
  187    22   194   120   185    57    71   186   166   181     5   153   170   203   147    93    53   130   209    16 
   41    64   244   198   145   247    84   165   174    30   153   131   248   102    30   226   186   230    87   157 
   96    78   174   249   199   163   148   153   183   226    84    76   185   199    86   201   246   211   144   217 
  161   225    75   203   115    90    41    49    87   205    33    38    24   196   174    34    44    51   167   130 
   87    93    89    48   161   126    75    58   106    74    17    13   146     9   244   227   231    63   102   216 
   24   198   161   245    29   171   152   218   106   190   197    62    49   104     5    17   155   112    68     7 
  123   104    84   236    33   214    97   180   174   107    24   249   228   248   105   196   225    56   232    53 
  139   207    70   164   148    42   148   118    49    50   122   244   119    16    17   177    21    91   233   220 
  177    27   162    19   137   189    15   161   193   150   212   100    32   174   248   164   116    34   143   119 
   74    78    36    49    38   139    78   185   184   121    97    14    72   129   201    53    43   191   242   118 
   25     6    36    28   105    25     9    60   122   147    27   226    27   207   164   170    68    83   199   139 
  210    19   106   229    98   124    43   202   245   234    33   123    14   197   229    63   130   204    77    20 
  148    54   218   164   241    38   194    89    76   210   133   249   148    56    31   213    31   165     8    63 
   39   186   162   218    84   145    72    71   175   121   142   157    35   221     8   144    13    44   157   218 


  229    29    77    52    47   146   130    29   163   162   172   233    92   171   105   145   243    69   175   114 
  156   196   106   172    89   192   222    38    97    53    30   202    95   114   115    97    70   194   147    92 
   87   145    18   165    91   120    98    26   157   122    76   128     8   231    39   208   206    23    87   233 
   44   196    42   148   100   157    44   150    50   204   106   171   223    54    89   227   196   249    61    70 
  193    12    65   250    31   103   151    90    30   194   188   228   221   131    39   151   220    73    60    80 
  151   164    21   249    29   102   237    49   119   104   105    42   135    24    31    99    83   118     5    19 
   77   156    33   236   166    50   237   184    90   196     4   195    58   115   138   195    24   245   104   241 
  147   155    95    33   235    35   126   150   201   150    60    75   184    71   209   108    98    38   219   214 
   83   114   177   119   245    55   248    16   139    13   181    15   172   114    85   245    48   186    93    82 
   75    55   212   207    68   171    93   179   120   213   211   181   173   203   240   151   124   164   118    27 
   33   172   127    81    40   215   156   147   149    46    22    62   125     1   159   100   233   244    13    62 
  162   204    49   103   187   119   242    39    39    50   192   160    92   110    13     3    40    95   223    47 
   70   210    92   150   139   162    41    48   117    98   106   119   152   186    94    26   101    41    36    67 
   74    43    27    28   184   154   209   130   193    58    35   215    40   183   205    20   198   196   220   175 
  188   174   217   205   249   183     9    83   197   176    59   137    53   148   213   131   111   101    52   136 
  231   169    15    45   183   138   197   231    75    40    65    63    24   108    28   164   240   100   161   222 
   10    50     7   110   122   118    53   182   116   150   132     1   164    70   137   105    77    66    45   119 
   29   158    40   219   121   211   108   145   247    35   208    55   133   204   104   224   109    63    17   178 
   42   147   172    62   156    39   123   154    28   233   103    55     4   162    97   202   222   191   238   183 
   39   144   130   185     2    45   228   207   194   169    30    91   147   104   124   230    27    27    37    41 


   53   242   222   121   227    51   167    48    19    35   116   194   179   223    85   103   107   154    52    14 
   68   230    11   121   137    55    49    30   214    20    82    60    80   167   144    82   184   191   185    10 
  212   227    53   198   169   133    74   169   170    42    99   157   182   227    44    15   219    21   193    77 
  124   103    93   174   103   130   226    70   180   238    96     9   204    70   135    23    24    13   202   179 
   19   201     5   238    79   224   227   227   150    63   193    61   187   142    36   196    52   245    41     4 
   72    11     1    85    66   150   205   166    35   138   126   172   205    40    90     3     4   101   167    51 
  215    10    46   115   155    58   188   229   156   226   219   210   100   214    58    98   127   141    47    99 
  228   159   207   192    48    55   222    50   171   116   176   234   130   193   168    92    28    58    48   110 
  245    68    61   227     8    89    36   159     3    71   146    25    81   115   172   185   208   243   210    93 
  214   191   201   173   156    33   135   214    27   196    22   170    79    67   134    98   113   146     7   162 
  234    67   180   105   123   174   164    26    82   186   183    56   122   241   190   234    79    49   171   244 
   96    68    25   209    52   182    34   107    14   245   204   163    83    81   210    26   188   124    45   105 
  248   246   103    13    71   204   131   206   215    64   202   109    87   190    76   160   190   154    88    25 
   89     9   200   153   148   181    57   150    25    15    19    51    93    42   175   125   207   183    85   229 
  204   212   151    33   202    63    63    73    54   147   236   231    54   163    45   210    18   101    56   104 
   36   216    48    81   221   119    86    54   157   249   235   185    94    15   212    62    77    32   161    24 
  194   191   118   132    77   122    86    95    11   126   187   179   178    30   163    93   194   234   237   148 
  238   163   214   229   181   116     1    13   188   211   160   182     3   110    65   206   161   241    97   179 
  119   160    30   205    53    33   170    30   105    72   224   128    82    20   110   161   169    15   155   193 
    4    27    52   175   187    45    89   213    88   147   152    82   176    20   113   200   185    70   144    29 


   30   101   195   185   177    13   155   111   124   194   100   175    21    81   231    76    14     8   247    60 
  137   200   129    39   195   250   104   111   214    47   153    91   194   213    93    67   234    43    36   172 
  129   154    77   165    76    94   154    50   242   159   243   223    80   223   161    24   190   200    41    10 
   41    61   159    47   176    42   174   156   124    44     6    39    23   139   113    71   243   144     2   151 
   89   159   200    96   137   208   123    15   213   232    23    20    73   124   241    27    31   225   148   231 
   31     5    73    96   136   159   139   233   115   146   181   235   199   176   110    58    12   102    44    35 
  234    62   170   220   202   143    97   174   171    82   196   206   143   215   204    82   176   222    10   153 
    4    31   119   100    40   143   198    46   116    35   126    73   152   111   191    34     5   246   211    18 
  148    53   115   201    72   130   159    51   216   236    78   204   140   158    60    78   186   211   133   130 
  196    97   179   178    68   135    89   183   135   129   139    22   119   158   183    14   206    59   150   166 
  155   114     9   209   109   194    55    31   216   237   152    61    21   210   167    22    79    77   220    54 
  114   144   195   228   119    65   196   152   240   171   213   246    31   192   184   143    92    34   191    60 
   97    10    58   230    99   165   128    31    24    19   163    84    50    17    31   187    54   198   125     6 
    6   110   134    72   125   140    80    87   146   207    57    53   239   180   238    78   151   242   105    52 
  232   140   137   118   195   108   148    68     9   227    95   249    23     7   104   140    52   163    85   219 
  205   103    76   244    43   158    51   192   101   210   102    97   184   144   157    22   109   140   182   173 
   73    91   106   239   181   172   169   146    98   209   198    91   112   173    69   216    73   234    94   241 
  192   193   199    79   204    66   167     7   164    83   203    31   201     4   117   161   151   157   245   125 
  151    96   202    59   182   127   100   100   114   190    83   162   217   186    57   178   115   165    15   188 
  154   184   218   157    72   183    66    74   104   249    72   197   213   242   188   226    42    85     4    48 


