22,11,1,8,38,29,26,34,30,;		11,1,35,38,29,6,34,30,43,;		1,35,16,29,6,26,30,43,18,;		35,16,50,6,26,19,43,18,42,;		16,50,5,26,19,10,18,42,28,;		50,5,16,19,10,50,42,28,8,;		5,16,35,10,50,14,28,8,48,;		16,35,38,50,14,8,8,48,10,;		35,38,26,14,8,48,48,10,45,;		38,26,22,8,48,27,10,45,18,;		26,22,5,48,27,41,45,18,11,;		22,5,40,27,41,47,18,11,27,;		5,40,40,41,47,49,11,27,8,;		40,40,3,47,49,28,27,8,39,;		40,3,4,49,28,9,8,39,36,;		3,4,1,28,9,7,39,36,9,;		4,1,17,9,7,42,36,9,3,;		1,17,1,7,42,48,9,3,21,;		17,1,15,42,48,5,3,21,46,;		1,15,10,48,5,22,21,46,25,;		15,10,46,5,22,50,46,25,31,;		10,46,15,22,50,21,25,31,15,;		46,15,5,50,21,16,31,15,22,;		
8,38,29,26,34,30,35,8,43,;		38,29,6,34,30,43,8,43,10,;		29,6,26,30,43,18,43,10,43,;		6,26,19,43,18,42,10,43,14,;		26,19,10,18,42,28,43,14,41,;		19,10,50,42,28,8,14,41,1,;		10,50,14,28,8,48,41,1,23,;		50,14,8,8,48,10,1,23,6,;		14,8,48,48,10,45,23,6,33,;		8,48,27,10,45,18,6,33,35,;		48,27,41,45,18,11,33,35,14,;		27,41,47,18,11,27,35,14,27,;		41,47,49,11,27,8,14,27,46,;		47,49,28,27,8,39,27,46,22,;		49,28,9,8,39,36,46,22,20,;		28,9,7,39,36,9,22,20,29,;		9,7,42,36,9,3,20,29,17,;		7,42,48,9,3,21,29,17,34,;		42,48,5,3,21,46,17,34,48,;		48,5,22,21,46,25,34,48,13,;		5,22,50,46,25,31,48,13,46,;		22,50,21,25,31,15,13,46,7,;		50,21,16,31,15,22,46,7,12,;		
26,34,30,35,8,43,34,17,30,;		34,30,43,8,43,10,17,30,5,;		30,43,18,43,10,43,30,5,23,;		43,18,42,10,43,14,5,23,24,;		18,42,28,43,14,41,23,24,14,;		42,28,8,14,41,1,24,14,26,;		28,8,48,41,1,23,14,26,32,;		8,48,10,1,23,6,26,32,36,;		48,10,45,23,6,33,32,36,33,;		10,45,18,6,33,35,36,33,6,;		45,18,11,33,35,14,33,6,22,;		18,11,27,35,14,27,6,22,41,;		11,27,8,14,27,46,22,41,40,;		27,8,39,27,46,22,41,40,34,;		8,39,36,46,22,20,40,34,29,;		39,36,9,22,20,29,34,29,49,;		36,9,3,20,29,17,29,49,21,;		9,3,21,29,17,34,49,21,44,;		3,21,46,17,34,48,21,44,46,;		21,46,25,34,48,13,44,46,18,;		46,25,31,48,13,46,46,18,25,;		25,31,15,13,46,7,18,25,9,;		31,15,22,46,7,12,25,9,2,;		
35,8,43,34,17,30,32,34,7,;		8,43,10,17,30,5,34,7,14,;		43,10,43,30,5,23,7,14,45,;		10,43,14,5,23,24,14,45,4,;		43,14,41,23,24,14,45,4,13,;		14,41,1,24,14,26,4,13,33,;		41,1,23,14,26,32,13,33,31,;		1,23,6,26,32,36,33,31,10,;		23,6,33,32,36,33,31,10,26,;		6,33,35,36,33,6,10,26,38,;		33,35,14,33,6,22,26,38,24,;		35,14,27,6,22,41,38,24,45,;		14,27,46,22,41,40,24,45,5,;		27,46,22,41,40,34,45,5,48,;		46,22,20,40,34,29,5,48,46,;		22,20,29,34,29,49,48,46,3,;		20,29,17,29,49,21,46,3,13,;		29,17,34,49,21,44,3,13,21,;		17,34,48,21,44,46,13,21,4,;		34,48,13,44,46,18,21,4,31,;		48,13,46,46,18,25,4,31,6,;		13,46,7,18,25,9,31,6,15,;		46,7,12,25,9,2,6,15,14,;		
34,17,30,32,34,7,2,9,37,;		17,30,5,34,7,14,9,37,40,;		30,5,23,7,14,45,37,40,26,;		5,23,24,14,45,4,40,26,10,;		23,24,14,45,4,13,26,10,40,;		24,14,26,4,13,33,10,40,4,;		14,26,32,13,33,31,40,4,38,;		26,32,36,33,31,10,4,38,25,;		32,36,33,31,10,26,38,25,39,;		36,33,6,10,26,38,25,39,9,;		33,6,22,26,38,24,39,9,50,;		6,22,41,38,24,45,9,50,3,;		22,41,40,24,45,5,50,3,48,;		41,40,34,45,5,48,3,48,31,;		40,34,29,5,48,46,48,31,7,;		34,29,49,48,46,3,31,7,50,;		29,49,21,46,3,13,7,50,25,;		49,21,44,3,13,21,50,25,15,;		21,44,46,13,21,4,25,15,19,;		44,46,18,21,4,31,15,19,1,;		46,18,25,4,31,6,19,1,43,;		18,25,9,31,6,15,1,43,42,;		25,9,2,6,15,14,43,42,25,;		
32,34,7,2,9,37,25,7,33,;		34,7,14,9,37,40,7,33,35,;		7,14,45,37,40,26,33,35,29,;		14,45,4,40,26,10,35,29,4,;		45,4,13,26,10,40,29,4,12,;		4,13,33,10,40,4,4,12,1,;		13,33,31,40,4,38,12,1,33,;		33,31,10,4,38,25,1,33,2,;		31,10,26,38,25,39,33,2,13,;		10,26,38,25,39,9,2,13,13,;		26,38,24,39,9,50,13,13,23,;		38,24,45,9,50,3,13,23,4,;		24,45,5,50,3,48,23,4,47,;		45,5,48,3,48,31,4,47,36,;		5,48,46,48,31,7,47,36,31,;		48,46,3,31,7,50,36,31,4,;		46,3,13,7,50,25,31,4,13,;		3,13,21,50,25,15,4,13,45,;		13,21,4,25,15,19,13,45,10,;		21,4,31,15,19,1,45,10,18,;		4,31,6,19,1,43,10,18,1,;		31,6,15,1,43,42,18,1,6,;		6,15,14,43,42,25,1,6,4,;		
2,9,37,25,7,33,36,16,48,;		9,37,40,7,33,35,16,48,31,;		37,40,26,33,35,29,48,31,21,;		40,26,10,35,29,4,31,21,19,;		26,10,40,29,4,12,21,19,36,;		10,40,4,4,12,1,19,36,4,;		40,4,38,12,1,33,36,4,7,;		4,38,25,1,33,2,4,7,49,;		38,25,39,33,2,13,7,49,35,;		25,39,9,2,13,13,49,35,35,;		39,9,50,13,13,23,35,35,44,;		9,50,3,13,23,4,35,44,15,;		50,3,48,23,4,47,44,15,12,;		3,48,31,4,47,36,15,12,12,;		48,31,7,47,36,31,12,12,27,;		31,7,50,36,31,4,12,27,32,;		7,50,25,31,4,13,27,32,11,;		50,25,15,4,13,45,32,11,24,;		25,15,19,13,45,10,11,24,44,;		15,19,1,45,10,18,24,44,41,;		19,1,43,10,18,1,44,41,18,;		1,43,42,18,1,6,41,18,32,;		43,42,25,1,6,4,18,32,27,;		
25,7,33,36,16,48,22,36,45,;		7,33,35,16,48,31,36,45,11,;		33,35,29,48,31,21,45,11,26,;		35,29,4,31,21,19,11,26,37,;		29,4,12,21,19,36,26,37,29,;		4,12,1,19,36,4,37,29,28,;		12,1,33,36,4,7,29,28,30,;		1,33,2,4,7,49,28,30,13,;		33,2,13,7,49,35,30,13,43,;		2,13,13,49,35,35,13,43,44,;		13,13,23,35,35,44,43,44,34,;		13,23,4,35,44,15,44,34,37,;		23,4,47,44,15,12,34,37,48,;		4,47,36,15,12,12,37,48,38,;		47,36,31,12,12,27,48,38,13,;		36,31,4,12,27,32,38,13,14,;		31,4,13,27,32,11,13,14,29,;		4,13,45,32,11,24,14,29,31,;		13,45,10,11,24,44,29,31,16,;		45,10,18,24,44,41,31,16,1,;		10,18,1,44,41,18,16,1,13,;		18,1,6,41,18,32,1,13,38,;		1,6,4,18,32,27,13,38,11,;		
36,16,48,22,36,45,10,32,3,;		16,48,31,36,45,11,32,3,10,;		48,31,21,45,11,26,3,10,15,;		31,21,19,11,26,37,10,15,6,;		21,19,36,26,37,29,15,6,11,;		19,36,4,37,29,28,6,11,41,;		36,4,7,29,28,30,11,41,47,;		4,7,49,28,30,13,41,47,29,;		7,49,35,30,13,43,47,29,19,;		49,35,35,13,43,44,29,19,10,;		35,35,44,43,44,34,19,10,30,;		35,44,15,44,34,37,10,30,5,;		44,15,12,34,37,48,30,5,3,;		15,12,12,37,48,38,5,3,33,;		12,12,27,48,38,13,3,33,20,;		12,27,32,38,13,14,33,20,30,;		27,32,11,13,14,29,20,30,5,;		32,11,24,14,29,31,30,5,22,;		11,24,44,29,31,16,5,22,24,;		24,44,41,31,16,1,22,24,28,;		44,41,18,16,1,13,24,28,32,;		41,18,32,1,13,38,28,32,20,;		18,32,27,13,38,11,32,20,10,;		
22,36,45,10,32,3,11,19,15,;		36,45,11,32,3,10,19,15,5,;		45,11,26,3,10,15,15,5,43,;		11,26,37,10,15,6,5,43,4,;		26,37,29,15,6,11,43,4,27,;		37,29,28,6,11,41,4,27,2,;		29,28,30,11,41,47,27,2,25,;		28,30,13,41,47,29,2,25,37,;		30,13,43,47,29,19,25,37,45,;		13,43,44,29,19,10,37,45,39,;		43,44,34,19,10,30,45,39,13,;		44,34,37,10,30,5,39,13,38,;		34,37,48,30,5,3,13,38,47,;		37,48,38,5,3,33,38,47,2,;		48,38,13,3,33,20,47,2,32,;		38,13,14,33,20,30,2,32,26,;		13,14,29,20,30,5,32,26,20,;		14,29,31,30,5,22,26,20,13,;		29,31,16,5,22,24,20,13,50,;		31,16,1,22,24,28,13,50,35,;		16,1,13,24,28,32,50,35,20,;		1,13,38,28,32,20,35,20,44,;		13,38,11,32,20,10,20,44,29,;		
10,32,3,11,19,15,30,1,45,;		32,3,10,19,15,5,1,45,35,;		3,10,15,15,5,43,45,35,27,;		10,15,6,5,43,4,35,27,13,;		15,6,11,43,4,27,27,13,5,;		6,11,41,4,27,2,13,5,11,;		11,41,47,27,2,25,5,11,24,;		41,47,29,2,25,37,11,24,44,;		47,29,19,25,37,45,24,44,50,;		29,19,10,37,45,39,44,50,25,;		19,10,30,45,39,13,50,25,21,;		10,30,5,39,13,38,25,21,31,;		30,5,3,13,38,47,21,31,31,;		5,3,33,38,47,2,31,31,26,;		3,33,20,47,2,32,31,26,14,;		33,20,30,2,32,26,26,14,8,;		20,30,5,32,26,20,14,8,47,;		30,5,22,26,20,13,8,47,10,;		5,22,24,20,13,50,47,10,37,;		22,24,28,13,50,35,10,37,50,;		24,28,32,50,35,20,37,50,29,;		28,32,20,35,20,44,50,29,39,;		32,20,10,20,44,29,29,39,45,;		
11,19,15,30,1,45,50,4,11,;		19,15,5,1,45,35,4,11,14,;		15,5,43,45,35,27,11,14,47,;		5,43,4,35,27,13,14,47,3,;		43,4,27,27,13,5,47,3,41,;		4,27,2,13,5,11,3,41,44,;		27,2,25,5,11,24,41,44,13,;		2,25,37,11,24,44,44,13,43,;		25,37,45,24,44,50,13,43,17,;		37,45,39,44,50,25,43,17,34,;		45,39,13,50,25,21,17,34,43,;		39,13,38,25,21,31,34,43,36,;		13,38,47,21,31,31,43,36,22,;		38,47,2,31,31,26,36,22,29,;		47,2,32,31,26,14,22,29,4,;		2,32,26,26,14,8,29,4,27,;		32,26,20,14,8,47,4,27,15,;		26,20,13,8,47,10,27,15,26,;		20,13,50,47,10,37,15,26,44,;		13,50,35,10,37,50,26,44,4,;		50,35,20,37,50,29,44,4,50,;		35,20,44,50,29,39,4,50,42,;		20,44,29,29,39,45,50,42,9,;		
30,1,45,50,4,11,43,23,30,;		1,45,35,4,11,14,23,30,23,;		45,35,27,11,14,47,30,23,11,;		35,27,13,14,47,3,23,11,24,;		27,13,5,47,3,41,11,24,40,;		13,5,11,3,41,44,24,40,50,;		5,11,24,41,44,13,40,50,41,;		11,24,44,44,13,43,50,41,10,;		24,44,50,13,43,17,41,10,41,;		44,50,25,43,17,34,10,41,11,;		50,25,21,17,34,43,41,11,9,;		25,21,31,34,43,36,11,9,47,;		21,31,31,43,36,22,9,47,26,;		31,31,26,36,22,29,47,26,42,;		31,26,14,22,29,4,26,42,24,;		26,14,8,29,4,27,42,24,6,;		14,8,47,4,27,15,24,6,24,;		8,47,10,27,15,26,6,24,44,;		47,10,37,15,26,44,24,44,6,;		10,37,50,26,44,4,44,6,39,;		37,50,29,44,4,50,6,39,23,;		50,29,39,4,50,42,39,23,39,;		29,39,45,50,42,9,23,39,13,;		
50,4,11,43,23,30,21,43,44,;		4,11,14,23,30,23,43,44,2,;		11,14,47,30,23,11,44,2,1,;		14,47,3,23,11,24,2,1,39,;		47,3,41,11,24,40,1,39,9,;		3,41,44,24,40,50,39,9,50,;		41,44,13,40,50,41,9,50,46,;		44,13,43,50,41,10,50,46,37,;		13,43,17,41,10,41,46,37,8,;		43,17,34,10,41,11,37,8,23,;		17,34,43,41,11,9,8,23,15,;		34,43,36,11,9,47,23,15,13,;		43,36,22,9,47,26,15,13,32,;		36,22,29,47,26,42,13,32,23,;		22,29,4,26,42,24,32,23,20,;		29,4,27,42,24,6,23,20,23,;		4,27,15,24,6,24,20,23,24,;		27,15,26,6,24,44,23,24,41,;		15,26,44,24,44,6,24,41,27,;		26,44,4,44,6,39,41,27,31,;		44,4,50,6,39,23,27,31,25,;		4,50,42,39,23,39,31,25,48,;		50,42,9,23,39,13,25,48,31,;		
43,23,30,21,43,44,31,5,23,;		23,30,23,43,44,2,5,23,46,;		30,23,11,44,2,1,23,46,36,;		23,11,24,2,1,39,46,36,9,;		11,24,40,1,39,9,36,9,39,;		24,40,50,39,9,50,9,39,33,;		40,50,41,9,50,46,39,33,15,;		50,41,10,50,46,37,33,15,46,;		41,10,41,46,37,8,15,46,31,;		10,41,11,37,8,23,46,31,35,;		41,11,9,8,23,15,31,35,49,;		11,9,47,23,15,13,35,49,26,;		9,47,26,15,13,32,49,26,10,;		47,26,42,13,32,23,26,10,8,;		26,42,24,32,23,20,10,8,12,;		42,24,6,23,20,23,8,12,2,;		24,6,24,20,23,24,12,2,44,;		6,24,44,23,24,41,2,44,35,;		24,44,6,24,41,27,44,35,34,;		44,6,39,41,27,31,35,34,12,;		6,39,23,27,31,25,34,12,20,;		39,23,39,31,25,48,12,20,20,;		23,39,13,25,48,31,20,20,2,;		
21,43,44,31,5,23,43,47,24,;		43,44,2,5,23,46,47,24,21,;		44,2,1,23,46,36,24,21,32,;		2,1,39,46,36,9,21,32,46,;		1,39,9,36,9,39,32,46,6,;		39,9,50,9,39,33,46,6,43,;		9,50,46,39,33,15,6,43,15,;		50,46,37,33,15,46,43,15,4,;		46,37,8,15,46,31,15,4,32,;		37,8,23,46,31,35,4,32,26,;		8,23,15,31,35,49,32,26,22,;		23,15,13,35,49,26,26,22,10,;		15,13,32,49,26,10,22,10,3,;		13,32,23,26,10,8,10,3,4,;		32,23,20,10,8,12,3,4,31,;		23,20,23,8,12,2,4,31,19,;		20,23,24,12,2,44,31,19,50,;		23,24,41,2,44,35,19,50,40,;		24,41,27,44,35,34,50,40,43,;		41,27,31,35,34,12,40,43,48,;		27,31,25,34,12,20,43,48,46,;		31,25,48,12,20,20,48,46,16,;		25,48,31,20,20,2,46,16,35,;		
31,5,23,43,47,24,26,23,2,;		5,23,46,47,24,21,23,2,11,;		23,46,36,24,21,32,2,11,41,;		46,36,9,21,32,46,11,41,34,;		36,9,39,32,46,6,41,34,5,;		9,39,33,46,6,43,34,5,46,;		39,33,15,6,43,15,5,46,11,;		33,15,46,43,15,4,46,11,18,;		15,46,31,15,4,32,11,18,48,;		46,31,35,4,32,26,18,48,3,;		31,35,49,32,26,22,48,3,15,;		35,49,26,26,22,10,3,15,1,;		49,26,10,22,10,3,15,1,22,;		26,10,8,10,3,4,1,22,30,;		10,8,12,3,4,31,22,30,9,;		8,12,2,4,31,19,30,9,1,;		12,2,44,31,19,50,9,1,16,;		2,44,35,19,50,40,1,16,36,;		44,35,34,50,40,43,16,36,28,;		35,34,12,40,43,48,36,28,4,;		34,12,20,43,48,46,28,4,40,;		12,20,20,48,46,16,4,40,8,;		20,20,2,46,16,35,40,8,10,;		
43,47,24,26,23,2,28,36,11,;		47,24,21,23,2,11,36,11,33,;		24,21,32,2,11,41,11,33,30,;		21,32,46,11,41,34,33,30,46,;		32,46,6,41,34,5,30,46,47,;		46,6,43,34,5,46,46,47,29,;		6,43,15,5,46,11,47,29,28,;		43,15,4,46,11,18,29,28,18,;		15,4,32,11,18,48,28,18,35,;		4,32,26,18,48,3,18,35,39,;		32,26,22,48,3,15,35,39,33,;		26,22,10,3,15,1,39,33,35,;		22,10,3,15,1,22,33,35,29,;		10,3,4,1,22,30,35,29,39,;		3,4,31,22,30,9,29,39,22,;		4,31,19,30,9,1,39,22,19,;		31,19,50,9,1,16,22,19,8,;		19,50,40,1,16,36,19,8,33,;		50,40,43,16,36,28,8,33,14,;		40,43,48,36,28,4,33,14,6,;		43,48,46,28,4,40,14,6,9,;		48,46,16,4,40,8,6,9,50,;		46,16,35,40,8,10,9,50,16,;		
26,23,2,28,36,11,5,14,9,;		23,2,11,36,11,33,14,9,9,;		2,11,41,11,33,30,9,9,9,;		11,41,34,33,30,46,9,9,44,;		41,34,5,30,46,47,9,44,5,;		34,5,46,46,47,29,44,5,31,;		5,46,11,47,29,28,5,31,16,;		46,11,18,29,28,18,31,16,37,;		11,18,48,28,18,35,16,37,2,;		18,48,3,18,35,39,37,2,11,;		48,3,15,35,39,33,2,11,21,;		3,15,1,39,33,35,11,21,10,;		15,1,22,33,35,29,21,10,17,;		1,22,30,35,29,39,10,17,22,;		22,30,9,29,39,22,17,22,29,;		30,9,1,39,22,19,22,29,27,;		9,1,16,22,19,8,29,27,20,;		1,16,36,19,8,33,27,20,4,;		16,36,28,8,33,14,20,4,14,;		36,28,4,33,14,6,4,14,44,;		28,4,40,14,6,9,14,44,45,;		4,40,8,6,9,50,44,45,28,;		40,8,10,9,50,16,45,28,19,;		
28,36,11,5,14,9,15,46,2,;		36,11,33,14,9,9,46,2,40,;		11,33,30,9,9,9,2,40,21,;		33,30,46,9,9,44,40,21,13,;		30,46,47,9,44,5,21,13,46,;		46,47,29,44,5,31,13,46,31,;		47,29,28,5,31,16,46,31,42,;		29,28,18,31,16,37,31,42,34,;		28,18,35,16,37,2,42,34,43,;		18,35,39,37,2,11,34,43,42,;		35,39,33,2,11,21,43,42,34,;		39,33,35,11,21,10,42,34,41,;		33,35,29,21,10,17,34,41,10,;		35,29,39,10,17,22,41,10,47,;		29,39,22,17,22,29,10,47,10,;		39,22,19,22,29,27,47,10,8,;		22,19,8,29,27,20,10,8,30,;		19,8,33,27,20,4,8,30,49,;		8,33,14,20,4,14,30,49,15,;		33,14,6,4,14,44,49,15,28,;		14,6,9,14,44,45,15,28,31,;		6,9,50,44,45,28,28,31,24,;		9,50,16,45,28,19,31,24,19,;		
5,14,9,15,46,2,13,34,50,;		14,9,9,46,2,40,34,50,17,;		9,9,9,2,40,21,50,17,31,;		9,9,44,40,21,13,17,31,37,;		9,44,5,21,13,46,31,37,4,;		44,5,31,13,46,31,37,4,48,;		5,31,16,46,31,42,4,48,25,;		31,16,37,31,42,34,48,25,6,;		16,37,2,42,34,43,25,6,6,;		37,2,11,34,43,42,6,6,10,;		2,11,21,43,42,34,6,10,34,;		11,21,10,42,34,41,10,34,22,;		21,10,17,34,41,10,34,22,25,;		10,17,22,41,10,47,22,25,40,;		17,22,29,10,47,10,25,40,30,;		22,29,27,47,10,8,40,30,37,;		29,27,20,10,8,30,30,37,46,;		27,20,4,8,30,49,37,46,7,;		20,4,14,30,49,15,46,7,7,;		4,14,44,49,15,28,7,7,3,;		14,44,45,15,28,31,7,3,39,;		44,45,28,28,31,24,3,39,30,;		45,28,19,31,24,19,39,30,38,;		
15,46,2,13,34,50,28,1,42,;		46,2,40,34,50,17,1,42,5,;		2,40,21,50,17,31,42,5,2,;		40,21,13,17,31,37,5,2,32,;		21,13,46,31,37,4,2,32,40,;		13,46,31,37,4,48,32,40,37,;		46,31,42,4,48,25,40,37,18,;		31,42,34,48,25,6,37,18,45,;		42,34,43,25,6,6,18,45,8,;		34,43,42,6,6,10,45,8,48,;		43,42,34,6,10,34,8,48,18,;		42,34,41,10,34,22,48,18,9,;		34,41,10,34,22,25,18,9,27,;		41,10,47,22,25,40,9,27,45,;		10,47,10,25,40,30,27,45,49,;		47,10,8,40,30,37,45,49,23,;		10,8,30,30,37,46,49,23,7,;		8,30,49,37,46,7,23,7,4,;		30,49,15,46,7,7,7,4,40,;		49,15,28,7,7,3,4,40,2,;		15,28,31,7,3,39,40,2,13,;		28,31,24,3,39,30,2,13,35,;		31,24,19,39,30,38,13,35,19,;		
13,34,50,28,1,42,5,3,26,;		34,50,17,1,42,5,3,26,44,;		50,17,31,42,5,2,26,44,43,;		17,31,37,5,2,32,44,43,8,;		31,37,4,2,32,40,43,8,1,;		37,4,48,32,40,37,8,1,42,;		4,48,25,40,37,18,1,42,1,;		48,25,6,37,18,45,42,1,10,;		25,6,6,18,45,8,1,10,2,;		6,6,10,45,8,48,10,2,47,;		6,10,34,8,48,18,2,47,34,;		10,34,22,48,18,9,47,34,44,;		34,22,25,18,9,27,34,44,7,;		22,25,40,9,27,45,44,7,22,;		25,40,30,27,45,49,7,22,9,;		40,30,37,45,49,23,22,9,40,;		30,37,46,49,23,7,9,40,32,;		37,46,7,23,7,4,40,32,23,;		46,7,7,7,4,40,32,23,23,;		7,7,3,4,40,2,23,23,41,;		7,3,39,40,2,13,23,41,6,;		3,39,30,2,13,35,41,6,39,;		39,30,38,13,35,19,6,39,31,;		


22,19,46,3,31,1,28,15,15,;		19,46,48,31,1,4,15,15,15,;		46,48,9,1,4,17,15,15,38,;		48,9,48,4,17,11,15,38,4,;		9,48,41,17,11,1,38,4,34,;		48,41,12,11,1,7,4,34,18,;		41,12,23,1,7,45,34,18,7,;		12,23,19,7,45,25,18,7,22,;		23,19,16,45,25,1,7,22,33,;		19,16,23,25,1,46,22,33,16,;		16,23,34,1,46,2,33,16,24,;		23,34,44,46,2,9,16,24,4,;		34,44,41,2,9,32,24,4,49,;		44,41,42,9,32,27,4,49,22,;		41,42,43,32,27,50,49,22,47,;		42,43,49,27,50,50,22,47,13,;		43,49,29,50,50,14,47,13,42,;		49,29,4,50,14,40,13,42,38,;		29,4,16,14,40,33,42,38,26,;		4,16,17,40,33,12,38,26,42,;		16,17,7,33,12,17,26,42,35,;		17,7,14,12,17,36,42,35,4,;		7,14,33,17,36,7,35,4,48,;		
3,31,1,28,15,15,1,41,2,;		31,1,4,15,15,15,41,2,34,;		1,4,17,15,15,38,2,34,12,;		4,17,11,15,38,4,34,12,1,;		17,11,1,38,4,34,12,1,22,;		11,1,7,4,34,18,1,22,24,;		1,7,45,34,18,7,22,24,31,;		7,45,25,18,7,22,24,31,32,;		45,25,1,7,22,33,31,32,24,;		25,1,46,22,33,16,32,24,5,;		1,46,2,33,16,24,24,5,30,;		46,2,9,16,24,4,5,30,13,;		2,9,32,24,4,49,30,13,38,;		9,32,27,4,49,22,13,38,38,;		32,27,50,49,22,47,38,38,44,;		27,50,50,22,47,13,38,44,2,;		50,50,14,47,13,42,44,2,32,;		50,14,40,13,42,38,2,32,11,;		14,40,33,42,38,26,32,11,13,;		40,33,12,38,26,42,11,13,40,;		33,12,17,26,42,35,13,40,18,;		12,17,36,42,35,4,40,18,9,;		17,36,7,35,4,48,18,9,45,;		
28,15,15,1,41,2,39,7,20,;		15,15,15,41,2,34,7,20,35,;		15,15,38,2,34,12,20,35,32,;		15,38,4,34,12,1,35,32,23,;		38,4,34,12,1,22,32,23,36,;		4,34,18,1,22,24,23,36,5,;		34,18,7,22,24,31,36,5,23,;		18,7,22,24,31,32,5,23,35,;		7,22,33,31,32,24,23,35,4,;		22,33,16,32,24,5,35,4,17,;		33,16,24,24,5,30,4,17,35,;		16,24,4,5,30,13,17,35,20,;		24,4,49,30,13,38,35,20,21,;		4,49,22,13,38,38,20,21,7,;		49,22,47,38,38,44,21,7,25,;		22,47,13,38,44,2,7,25,17,;		47,13,42,44,2,32,25,17,21,;		13,42,38,2,32,11,17,21,25,;		42,38,26,32,11,13,21,25,42,;		38,26,42,11,13,40,25,42,13,;		26,42,35,13,40,18,42,13,42,;		42,35,4,40,18,9,13,42,10,;		35,4,48,18,9,45,42,10,48,;		
1,41,2,39,7,20,3,33,23,;		41,2,34,7,20,35,33,23,9,;		2,34,12,20,35,32,23,9,45,;		34,12,1,35,32,23,9,45,49,;		12,1,22,32,23,36,45,49,13,;		1,22,24,23,36,5,49,13,43,;		22,24,31,36,5,23,13,43,41,;		24,31,32,5,23,35,43,41,1,;		31,32,24,23,35,4,41,1,10,;		32,24,5,35,4,17,1,10,23,;		24,5,30,4,17,35,10,23,47,;		5,30,13,17,35,20,23,47,21,;		30,13,38,35,20,21,47,21,14,;		13,38,38,20,21,7,21,14,18,;		38,38,44,21,7,25,14,18,16,;		38,44,2,7,25,17,18,16,33,;		44,2,32,25,17,21,16,33,15,;		2,32,11,17,21,25,33,15,24,;		32,11,13,21,25,42,15,24,39,;		11,13,40,25,42,13,24,39,1,;		13,40,18,42,13,42,39,1,44,;		40,18,9,13,42,10,1,44,10,;		18,9,45,42,10,48,44,10,50,;		
39,7,20,3,33,23,19,21,34,;		7,20,35,33,23,9,21,34,6,;		20,35,32,23,9,45,34,6,34,;		35,32,23,9,45,49,6,34,30,;		32,23,36,45,49,13,34,30,29,;		23,36,5,49,13,43,30,29,10,;		36,5,23,13,43,41,29,10,33,;		5,23,35,43,41,1,10,33,47,;		23,35,4,41,1,10,33,47,10,;		35,4,17,1,10,23,47,10,45,;		4,17,35,10,23,47,10,45,16,;		17,35,20,23,47,21,45,16,12,;		35,20,21,47,21,14,16,12,17,;		20,21,7,21,14,18,12,17,42,;		21,7,25,14,18,16,17,42,6,;		7,25,17,18,16,33,42,6,30,;		25,17,21,16,33,15,6,30,32,;		17,21,25,33,15,24,30,32,48,;		21,25,42,15,24,39,32,48,13,;		25,42,13,24,39,1,48,13,20,;		42,13,42,39,1,44,13,20,48,;		13,42,10,1,44,10,20,48,47,;		42,10,48,44,10,50,48,47,37,;		
3,33,23,19,21,34,16,37,46,;		33,23,9,21,34,6,37,46,45,;		23,9,45,34,6,34,46,45,29,;		9,45,49,6,34,30,45,29,37,;		45,49,13,34,30,29,29,37,26,;		49,13,43,30,29,10,37,26,11,;		13,43,41,29,10,33,26,11,27,;		43,41,1,10,33,47,11,27,21,;		41,1,10,33,47,10,27,21,42,;		1,10,23,47,10,45,21,42,46,;		10,23,47,10,45,16,42,46,32,;		23,47,21,45,16,12,46,32,40,;		47,21,14,16,12,17,32,40,41,;		21,14,18,12,17,42,40,41,8,;		14,18,16,17,42,6,41,8,48,;		18,16,33,42,6,30,8,48,7,;		16,33,15,6,30,32,48,7,29,;		33,15,24,30,32,48,7,29,6,;		15,24,39,32,48,13,29,6,15,;		24,39,1,48,13,20,6,15,9,;		39,1,44,13,20,48,15,9,26,;		1,44,10,20,48,47,9,26,5,;		44,10,50,48,47,37,26,5,36,;		
19,21,34,16,37,46,38,44,40,;		21,34,6,37,46,45,44,40,20,;		34,6,34,46,45,29,40,20,14,;		6,34,30,45,29,37,20,14,45,;		34,30,29,29,37,26,14,45,9,;		30,29,10,37,26,11,45,9,12,;		29,10,33,26,11,27,9,12,25,;		10,33,47,11,27,21,12,25,18,;		33,47,10,27,21,42,25,18,28,;		47,10,45,21,42,46,18,28,39,;		10,45,16,42,46,32,28,39,45,;		45,16,12,46,32,40,39,45,37,;		16,12,17,32,40,41,45,37,48,;		12,17,42,40,41,8,37,48,46,;		17,42,6,41,8,48,48,46,3,;		42,6,30,8,48,7,46,3,37,;		6,30,32,48,7,29,3,37,10,;		30,32,48,7,29,6,37,10,12,;		32,48,13,29,6,15,10,12,20,;		48,13,20,6,15,9,12,20,24,;		13,20,48,15,9,26,20,24,1,;		20,48,47,9,26,5,24,1,50,;		48,47,37,26,5,36,1,50,49,;		
16,37,46,38,44,40,33,22,2,;		37,46,45,44,40,20,22,2,36,;		46,45,29,40,20,14,2,36,42,;		45,29,37,20,14,45,36,42,6,;		29,37,26,14,45,9,42,6,21,;		37,26,11,45,9,12,6,21,37,;		26,11,27,9,12,25,21,37,34,;		11,27,21,12,25,18,37,34,35,;		27,21,42,25,18,28,34,35,38,;		21,42,46,18,28,39,35,38,32,;		42,46,32,28,39,45,38,32,9,;		46,32,40,39,45,37,32,9,14,;		32,40,41,45,37,48,9,14,1,;		40,41,8,37,48,46,14,1,18,;		41,8,48,48,46,3,1,18,15,;		8,48,7,46,3,37,18,15,42,;		48,7,29,3,37,10,15,42,45,;		7,29,6,37,10,12,42,45,25,;		29,6,15,10,12,20,45,25,1,;		6,15,9,12,20,24,25,1,47,;		15,9,26,20,24,1,1,47,29,;		9,26,5,24,1,50,47,29,48,;		26,5,36,1,50,49,29,48,50,;		
38,44,40,33,22,2,36,17,5,;		44,40,20,22,2,36,17,5,20,;		40,20,14,2,36,42,5,20,3,;		20,14,45,36,42,6,20,3,49,;		14,45,9,42,6,21,3,49,4,;		45,9,12,6,21,37,49,4,26,;		9,12,25,21,37,34,4,26,6,;		12,25,18,37,34,35,26,6,12,;		25,18,28,34,35,38,6,12,47,;		18,28,39,35,38,32,12,47,5,;		28,39,45,38,32,9,47,5,1,;		39,45,37,32,9,14,5,1,43,;		45,37,48,9,14,1,1,43,35,;		37,48,46,14,1,18,43,35,47,;		48,46,3,1,18,15,35,47,39,;		46,3,37,18,15,42,47,39,4,;		3,37,10,15,42,45,39,4,39,;		37,10,12,42,45,25,4,39,43,;		10,12,20,45,25,1,39,43,39,;		12,20,24,25,1,47,43,39,22,;		20,24,1,1,47,29,39,22,49,;		24,1,50,47,29,48,22,49,47,;		1,50,49,29,48,50,49,47,1,;		
33,22,2,36,17,5,36,31,33,;		22,2,36,17,5,20,31,33,8,;		2,36,42,5,20,3,33,8,33,;		36,42,6,20,3,49,8,33,27,;		42,6,21,3,49,4,33,27,40,;		6,21,37,49,4,26,27,40,15,;		21,37,34,4,26,6,40,15,50,;		37,34,35,26,6,12,15,50,10,;		34,35,38,6,12,47,50,10,10,;		35,38,32,12,47,5,10,10,24,;		38,32,9,47,5,1,10,24,32,;		32,9,14,5,1,43,24,32,34,;		9,14,1,1,43,35,32,34,28,;		14,1,18,43,35,47,34,28,27,;		1,18,15,35,47,39,28,27,49,;		18,15,42,47,39,4,27,49,22,;		15,42,45,39,4,39,49,22,26,;		42,45,25,4,39,43,22,26,20,;		45,25,1,39,43,39,26,20,33,;		25,1,47,43,39,22,20,33,1,;		1,47,29,39,22,49,33,1,6,;		47,29,48,22,49,47,1,6,26,;		29,48,50,49,47,1,6,26,20,;		
36,17,5,36,31,33,25,29,28,;		17,5,20,31,33,8,29,28,45,;		5,20,3,33,8,33,28,45,13,;		20,3,49,8,33,27,45,13,43,;		3,49,4,33,27,40,13,43,11,;		49,4,26,27,40,15,43,11,16,;		4,26,6,40,15,50,11,16,38,;		26,6,12,15,50,10,16,38,2,;		6,12,47,50,10,10,38,2,42,;		12,47,5,10,10,24,2,42,41,;		47,5,1,10,24,32,42,41,40,;		5,1,43,24,32,34,41,40,12,;		1,43,35,32,34,28,40,12,34,;		43,35,47,34,28,27,12,34,36,;		35,47,39,28,27,49,34,36,42,;		47,39,4,27,49,22,36,42,9,;		39,4,39,49,22,26,42,9,41,;		4,39,43,22,26,20,9,41,11,;		39,43,39,26,20,33,41,11,46,;		43,39,22,20,33,1,11,46,33,;		39,22,49,33,1,6,46,33,36,;		22,49,47,1,6,26,33,36,36,;		49,47,1,6,26,20,36,36,39,;		
36,31,33,25,29,28,41,47,42,;		31,33,8,29,28,45,47,42,43,;		33,8,33,28,45,13,42,43,6,;		8,33,27,45,13,43,43,6,31,;		33,27,40,13,43,11,6,31,2,;		27,40,15,43,11,16,31,2,26,;		40,15,50,11,16,38,2,26,11,;		15,50,10,16,38,2,26,11,22,;		50,10,10,38,2,42,11,22,33,;		10,10,24,2,42,41,22,33,7,;		10,24,32,42,41,40,33,7,15,;		24,32,34,41,40,12,7,15,20,;		32,34,28,40,12,34,15,20,38,;		34,28,27,12,34,36,20,38,27,;		28,27,49,34,36,42,38,27,4,;		27,49,22,36,42,9,27,4,43,;		49,22,26,42,9,41,4,43,17,;		22,26,20,9,41,11,43,17,45,;		26,20,33,41,11,46,17,45,21,;		20,33,1,11,46,33,45,21,5,;		33,1,6,46,33,36,21,5,27,;		1,6,26,33,36,36,5,27,8,;		6,26,20,36,36,39,27,8,48,;		
25,29,28,41,47,42,19,19,7,;		29,28,45,47,42,43,19,7,5,;		28,45,13,42,43,6,7,5,31,;		45,13,43,43,6,31,5,31,25,;		13,43,11,6,31,2,31,25,2,;		43,11,16,31,2,26,25,2,28,;		11,16,38,2,26,11,2,28,5,;		16,38,2,26,11,22,28,5,42,;		38,2,42,11,22,33,5,42,15,;		2,42,41,22,33,7,42,15,42,;		42,41,40,33,7,15,15,42,15,;		41,40,12,7,15,20,42,15,42,;		40,12,34,15,20,38,15,42,40,;		12,34,36,20,38,27,42,40,43,;		34,36,42,38,27,4,40,43,29,;		36,42,9,27,4,43,43,29,1,;		42,9,41,4,43,17,29,1,6,;		9,41,11,43,17,45,1,6,11,;		41,11,46,17,45,21,6,11,38,;		11,46,33,45,21,5,11,38,8,;		46,33,36,21,5,27,38,8,24,;		33,36,36,5,27,8,8,24,31,;		36,36,39,27,8,48,24,31,6,;		
41,47,42,19,19,7,3,18,38,;		47,42,43,19,7,5,18,38,29,;		42,43,6,7,5,31,38,29,23,;		43,6,31,5,31,25,29,23,45,;		6,31,2,31,25,2,23,45,8,;		31,2,26,25,2,28,45,8,33,;		2,26,11,2,28,5,8,33,28,;		26,11,22,28,5,42,33,28,28,;		11,22,33,5,42,15,28,28,7,;		22,33,7,42,15,42,28,7,22,;		33,7,15,15,42,15,7,22,44,;		7,15,20,42,15,42,22,44,24,;		15,20,38,15,42,40,44,24,2,;		20,38,27,42,40,43,24,2,42,;		38,27,4,40,43,29,2,42,37,;		27,4,43,43,29,1,42,37,26,;		4,43,17,29,1,6,37,26,41,;		43,17,45,1,6,11,26,41,6,;		17,45,21,6,11,38,41,6,6,;		45,21,5,11,38,8,6,6,37,;		21,5,27,38,8,24,6,37,2,;		5,27,8,8,24,31,37,2,8,;		27,8,48,24,31,6,2,8,14,;		
19,19,7,3,18,38,7,33,29,;		19,7,5,18,38,29,33,29,27,;		7,5,31,38,29,23,29,27,3,;		5,31,25,29,23,45,27,3,23,;		31,25,2,23,45,8,3,23,24,;		25,2,28,45,8,33,23,24,40,;		2,28,5,8,33,28,24,40,50,;		28,5,42,33,28,28,40,50,6,;		5,42,15,28,28,7,50,6,21,;		42,15,42,28,7,22,6,21,27,;		15,42,15,7,22,44,21,27,32,;		42,15,42,22,44,24,27,32,17,;		15,42,40,44,24,2,32,17,31,;		42,40,43,24,2,42,17,31,18,;		40,43,29,2,42,37,31,18,10,;		43,29,1,42,37,26,18,10,39,;		29,1,6,37,26,41,10,39,41,;		1,6,11,26,41,6,39,41,43,;		6,11,38,41,6,6,41,43,50,;		11,38,8,6,6,37,43,50,9,;		38,8,24,6,37,2,50,9,18,;		8,24,31,37,2,8,9,18,11,;		24,31,6,2,8,14,18,11,39,;		
3,18,38,7,33,29,3,2,50,;		18,38,29,33,29,27,2,50,1,;		38,29,23,29,27,3,50,1,15,;		29,23,45,27,3,23,1,15,27,;		23,45,8,3,23,24,15,27,30,;		45,8,33,23,24,40,27,30,50,;		8,33,28,24,40,50,30,50,50,;		33,28,28,40,50,6,50,50,16,;		28,28,7,50,6,21,50,16,11,;		28,7,22,6,21,27,16,11,37,;		7,22,44,21,27,32,11,37,4,;		22,44,24,27,32,17,37,4,30,;		44,24,2,32,17,31,4,30,13,;		24,2,42,17,31,18,30,13,17,;		2,42,37,31,18,10,13,17,28,;		42,37,26,18,10,39,17,28,2,;		37,26,41,10,39,41,28,2,48,;		26,41,6,39,41,43,2,48,12,;		41,6,6,41,43,50,48,12,16,;		6,6,37,43,50,9,12,16,2,;		6,37,2,50,9,18,16,2,14,;		37,2,8,9,18,11,2,14,8,;		2,8,14,18,11,39,14,8,8,;		
7,33,29,3,2,50,9,11,33,;		33,29,27,2,50,1,11,33,38,;		29,27,3,50,1,15,33,38,43,;		27,3,23,1,15,27,38,43,26,;		3,23,24,15,27,30,43,26,44,;		23,24,40,27,30,50,26,44,26,;		24,40,50,30,50,50,44,26,48,;		40,50,6,50,50,16,26,48,33,;		50,6,21,50,16,11,48,33,19,;		6,21,27,16,11,37,33,19,21,;		21,27,32,11,37,4,19,21,35,;		27,32,17,37,4,30,21,35,3,;		32,17,31,4,30,13,35,3,18,;		17,31,18,30,13,17,3,18,26,;		31,18,10,13,17,28,18,26,37,;		18,10,39,17,28,2,26,37,48,;		10,39,41,28,2,48,37,48,31,;		39,41,43,2,48,12,48,31,4,;		41,43,50,48,12,16,31,4,26,;		43,50,9,12,16,2,4,26,15,;		50,9,18,16,2,14,26,15,28,;		9,18,11,2,14,8,15,28,14,;		18,11,39,14,8,8,28,14,26,;		
3,2,50,9,11,33,20,25,40,;		2,50,1,11,33,38,25,40,34,;		50,1,15,33,38,43,40,34,43,;		1,15,27,38,43,26,34,43,33,;		15,27,30,43,26,44,43,33,24,;		27,30,50,26,44,26,33,24,39,;		30,50,50,44,26,48,24,39,42,;		50,50,16,26,48,33,39,42,9,;		50,16,11,48,33,19,42,9,19,;		16,11,37,33,19,21,9,19,24,;		11,37,4,19,21,35,19,24,39,;		37,4,30,21,35,3,24,39,7,;		4,30,13,35,3,18,39,7,25,;		30,13,17,3,18,26,7,25,19,;		13,17,28,18,26,37,25,19,4,;		17,28,2,26,37,48,19,4,31,;		28,2,48,37,48,31,4,31,21,;		2,48,12,48,31,4,31,21,17,;		48,12,16,31,4,26,21,17,47,;		12,16,2,4,26,15,17,47,16,;		16,2,14,26,15,28,47,16,38,;		2,14,8,15,28,14,16,38,43,;		14,8,8,28,14,26,38,43,4,;		
9,11,33,20,25,40,39,18,29,;		11,33,38,25,40,34,18,29,9,;		33,38,43,40,34,43,29,9,2,;		38,43,26,34,43,33,9,2,49,;		43,26,44,43,33,24,2,49,8,;		26,44,26,33,24,39,49,8,47,;		44,26,48,24,39,42,8,47,21,;		26,48,33,39,42,9,47,21,50,;		48,33,19,42,9,19,21,50,15,;		33,19,21,9,19,24,50,15,28,;		19,21,35,19,24,39,15,28,10,;		21,35,3,24,39,7,28,10,38,;		35,3,18,39,7,25,10,38,21,;		3,18,26,7,25,19,38,21,12,;		18,26,37,25,19,4,21,12,1,;		26,37,48,19,4,31,12,1,1,;		37,48,31,4,31,21,1,1,43,;		48,31,4,31,21,17,1,43,14,;		31,4,26,21,17,47,43,14,18,;		4,26,15,17,47,16,14,18,15,;		26,15,28,47,16,38,18,15,35,;		15,28,14,16,38,43,15,35,49,;		28,14,26,38,43,4,35,49,33,;		
20,25,40,39,18,29,9,21,45,;		25,40,34,18,29,9,21,45,10,;		40,34,43,29,9,2,45,10,29,;		34,43,33,9,2,49,10,29,27,;		43,33,24,2,49,8,29,27,41,;		33,24,39,49,8,47,27,41,6,;		24,39,42,8,47,21,41,6,50,;		39,42,9,47,21,50,6,50,14,;		42,9,19,21,50,15,50,14,27,;		9,19,24,50,15,28,14,27,26,;		19,24,39,15,28,10,27,26,1,;		24,39,7,28,10,38,26,1,17,;		39,7,25,10,38,21,1,17,12,;		7,25,19,38,21,12,17,12,33,;		25,19,4,21,12,1,12,33,14,;		19,4,31,12,1,1,33,14,45,;		4,31,21,1,1,43,14,45,37,;		31,21,17,1,43,14,45,37,49,;		21,17,47,43,14,18,37,49,12,;		17,47,16,14,18,15,49,12,37,;		47,16,38,18,15,35,12,37,20,;		16,38,43,15,35,49,37,20,6,;		38,43,4,35,49,33,20,6,38,;		
39,18,29,9,21,45,13,15,8,;		18,29,9,21,45,10,15,8,27,;		29,9,2,45,10,29,8,27,41,;		9,2,49,10,29,27,27,41,30,;		2,49,8,29,27,41,41,30,30,;		49,8,47,27,41,6,30,30,19,;		8,47,21,41,6,50,30,19,10,;		47,21,50,6,50,14,19,10,23,;		21,50,15,50,14,27,10,23,22,;		50,15,28,14,27,26,23,22,3,;		15,28,10,27,26,1,22,3,47,;		28,10,38,26,1,17,3,47,27,;		10,38,21,1,17,12,47,27,13,;		38,21,12,17,12,33,27,13,36,;		21,12,1,12,33,14,13,36,5,;		12,1,1,33,14,45,36,5,33,;		1,1,43,14,45,37,5,33,44,;		1,43,14,45,37,49,33,44,25,;		43,14,18,37,49,12,44,25,30,;		14,18,15,49,12,37,25,30,43,;		18,15,35,12,37,20,30,43,27,;		15,35,49,37,20,6,43,27,44,;		35,49,33,20,6,38,27,44,22,;		
9,21,45,13,15,8,23,32,1,;		21,45,10,15,8,27,32,1,11,;		45,10,29,8,27,41,1,11,47,;		10,29,27,27,41,30,11,47,26,;		29,27,41,41,30,30,47,26,12,;		27,41,6,30,30,19,26,12,16,;		41,6,50,30,19,10,12,16,33,;		6,50,14,19,10,23,16,33,24,;		50,14,27,10,23,22,33,24,9,;		14,27,26,23,22,3,24,9,34,;		27,26,1,22,3,47,9,34,11,;		26,1,17,3,47,27,34,11,10,;		1,17,12,47,27,13,11,10,34,;		17,12,33,27,13,36,10,34,33,;		12,33,14,13,36,5,34,33,26,;		33,14,45,36,5,33,33,26,29,;		14,45,37,5,33,44,26,29,8,;		45,37,49,33,44,25,29,8,13,;		37,49,12,44,25,30,8,13,1,;		49,12,37,25,30,43,13,1,26,;		12,37,20,30,43,27,1,26,3,;		37,20,6,43,27,44,26,3,37,;		20,6,38,27,44,22,3,37,18,;		
13,15,8,23,32,1,37,44,27,;		15,8,27,32,1,11,44,27,5,;		8,27,41,1,11,47,27,5,2,;		27,41,30,11,47,26,5,2,47,;		41,30,30,47,26,12,2,47,38,;		30,30,19,26,12,16,47,38,31,;		30,19,10,12,16,33,38,31,14,;		19,10,23,16,33,24,31,14,29,;		10,23,22,33,24,9,14,29,11,;		23,22,3,24,9,34,29,11,3,;		22,3,47,9,34,11,11,3,9,;		3,47,27,34,11,10,3,9,23,;		47,27,13,11,10,34,9,23,35,;		27,13,36,10,34,33,23,35,24,;		13,36,5,34,33,26,35,24,1,;		36,5,33,33,26,29,24,1,41,;		5,33,44,26,29,8,1,41,30,;		33,44,25,29,8,13,41,30,27,;		44,25,30,8,13,1,30,27,1,;		25,30,43,13,1,26,27,1,10,;		30,43,27,1,26,3,1,10,48,;		43,27,44,26,3,37,10,48,3,;		27,44,22,3,37,18,48,3,8,;		


