9,18,44,35,42,27,32,17,7,;		18,44,7,42,27,48,17,7,43,;		44,7,34,27,48,33,7,43,23,;		7,34,13,48,33,22,43,23,31,;		34,13,38,33,22,4,23,31,43,;		13,38,47,22,4,6,31,43,13,;		38,47,30,4,6,40,43,13,27,;		47,30,16,6,40,47,13,27,29,;		30,16,32,40,47,25,27,29,5,;		16,32,38,47,25,46,29,5,17,;		32,38,38,25,46,12,5,17,10,;		38,38,5,46,12,3,17,10,49,;		38,5,39,12,3,47,10,49,15,;		5,39,31,3,47,42,49,15,45,;		39,31,6,47,42,49,15,45,7,;		31,6,36,42,49,29,45,7,23,;		6,36,29,49,29,6,7,23,39,;		36,29,36,29,6,44,23,39,1,;		29,36,4,6,44,20,39,1,46,;		36,4,36,44,20,15,1,46,22,;		4,36,32,20,15,34,46,22,1,;		36,32,49,15,34,16,22,1,31,;		32,49,19,34,16,46,1,31,16,;		
35,42,27,32,17,7,26,12,16,;		42,27,48,17,7,43,12,16,26,;		27,48,33,7,43,23,16,26,36,;		48,33,22,43,23,31,26,36,20,;		33,22,4,23,31,43,36,20,25,;		22,4,6,31,43,13,20,25,22,;		4,6,40,43,13,27,25,22,39,;		6,40,47,13,27,29,22,39,47,;		40,47,25,27,29,5,39,47,50,;		47,25,46,29,5,17,47,50,34,;		25,46,12,5,17,10,50,34,2,;		46,12,3,17,10,49,34,2,9,;		12,3,47,10,49,15,2,9,44,;		3,47,42,49,15,45,9,44,16,;		47,42,49,15,45,7,44,16,27,;		42,49,29,45,7,23,16,27,20,;		49,29,6,7,23,39,27,20,43,;		29,6,44,23,39,1,20,43,28,;		6,44,20,39,1,46,43,28,47,;		44,20,15,1,46,22,28,47,45,;		20,15,34,46,22,1,47,45,7,;		15,34,16,22,1,31,45,7,30,;		34,16,46,1,31,16,7,30,27,;		
32,17,7,26,12,16,24,10,44,;		17,7,43,12,16,26,10,44,38,;		7,43,23,16,26,36,44,38,23,;		43,23,31,26,36,20,38,23,30,;		23,31,43,36,20,25,23,30,21,;		31,43,13,20,25,22,30,21,27,;		43,13,27,25,22,39,21,27,5,;		13,27,29,22,39,47,27,5,16,;		27,29,5,39,47,50,5,16,22,;		29,5,17,47,50,34,16,22,18,;		5,17,10,50,34,2,22,18,3,;		17,10,49,34,2,9,18,3,48,;		10,49,15,2,9,44,3,48,18,;		49,15,45,9,44,16,48,18,14,;		15,45,7,44,16,27,18,14,26,;		45,7,23,16,27,20,14,26,46,;		7,23,39,27,20,43,26,46,35,;		23,39,1,20,43,28,46,35,35,;		39,1,46,43,28,47,35,35,49,;		1,46,22,28,47,45,35,49,40,;		46,22,1,47,45,7,49,40,32,;		22,1,31,45,7,30,40,32,48,;		1,31,16,7,30,27,32,48,18,;		
26,12,16,24,10,44,26,43,2,;		12,16,26,10,44,38,43,2,1,;		16,26,36,44,38,23,2,1,8,;		26,36,20,38,23,30,1,8,7,;		36,20,25,23,30,21,8,7,3,;		20,25,22,30,21,27,7,3,1,;		25,22,39,21,27,5,3,1,2,;		22,39,47,27,5,16,1,2,30,;		39,47,50,5,16,22,2,30,34,;		47,50,34,16,22,18,30,34,4,;		50,34,2,22,18,3,34,4,13,;		34,2,9,18,3,48,4,13,2,;		2,9,44,3,48,18,13,2,22,;		9,44,16,48,18,14,2,22,33,;		44,16,27,18,14,26,22,33,46,;		16,27,20,14,26,46,33,46,6,;		27,20,43,26,46,35,46,6,11,;		20,43,28,46,35,35,6,11,48,;		43,28,47,35,35,49,11,48,9,;		28,47,45,35,49,40,48,9,23,;		47,45,7,49,40,32,9,23,4,;		45,7,30,40,32,48,23,4,9,;		7,30,27,32,48,18,4,9,17,;		
24,10,44,26,43,2,22,20,31,;		10,44,38,43,2,1,20,31,2,;		44,38,23,2,1,8,31,2,47,;		38,23,30,1,8,7,2,47,49,;		23,30,21,8,7,3,47,49,18,;		30,21,27,7,3,1,49,18,2,;		21,27,5,3,1,2,18,2,32,;		27,5,16,1,2,30,2,32,45,;		5,16,22,2,30,34,32,45,36,;		16,22,18,30,34,4,45,36,33,;		22,18,3,34,4,13,36,33,17,;		18,3,48,4,13,2,33,17,1,;		3,48,18,13,2,22,17,1,3,;		48,18,14,2,22,33,1,3,8,;		18,14,26,22,33,46,3,8,34,;		14,26,46,33,46,6,8,34,7,;		26,46,35,46,6,11,34,7,33,;		46,35,35,6,11,48,7,33,19,;		35,35,49,11,48,9,33,19,42,;		35,49,40,48,9,23,19,42,35,;		49,40,32,9,23,4,42,35,9,;		40,32,48,23,4,9,35,9,31,;		32,48,18,4,9,17,9,31,16,;		
26,43,2,22,20,31,40,30,28,;		43,2,1,20,31,2,30,28,7,;		2,1,8,31,2,47,28,7,17,;		1,8,7,2,47,49,7,17,11,;		8,7,3,47,49,18,17,11,27,;		7,3,1,49,18,2,11,27,4,;		3,1,2,18,2,32,27,4,39,;		1,2,30,2,32,45,4,39,34,;		2,30,34,32,45,36,39,34,31,;		30,34,4,45,36,33,34,31,19,;		34,4,13,36,33,17,31,19,3,;		4,13,2,33,17,1,19,3,18,;		13,2,22,17,1,3,3,18,4,;		2,22,33,1,3,8,18,4,26,;		22,33,46,3,8,34,4,26,7,;		33,46,6,8,34,7,26,7,32,;		46,6,11,34,7,33,7,32,50,;		6,11,48,7,33,19,32,50,10,;		11,48,9,33,19,42,50,10,38,;		48,9,23,19,42,35,10,38,10,;		9,23,4,42,35,9,38,10,33,;		23,4,9,35,9,31,10,33,4,;		4,9,17,9,31,16,33,4,34,;		
22,20,31,40,30,28,12,24,15,;		20,31,2,30,28,7,24,15,3,;		31,2,47,28,7,17,15,3,33,;		2,47,49,7,17,11,3,33,28,;		47,49,18,17,11,27,33,28,13,;		49,18,2,11,27,4,28,13,13,;		18,2,32,27,4,39,13,13,18,;		2,32,45,4,39,34,13,18,17,;		32,45,36,39,34,31,18,17,20,;		45,36,33,34,31,19,17,20,36,;		36,33,17,31,19,3,20,36,27,;		33,17,1,19,3,18,36,27,45,;		17,1,3,3,18,4,27,45,17,;		1,3,8,18,4,26,45,17,17,;		3,8,34,4,26,7,17,17,9,;		8,34,7,26,7,32,17,9,7,;		34,7,33,7,32,50,9,7,25,;		7,33,19,32,50,10,7,25,39,;		33,19,42,50,10,38,25,39,7,;		19,42,35,10,38,10,39,7,23,;		42,35,9,38,10,33,7,23,13,;		35,9,31,10,33,4,23,13,1,;		9,31,16,33,4,34,13,1,33,;		
40,30,28,12,24,15,3,30,37,;		30,28,7,24,15,3,30,37,37,;		28,7,17,15,3,33,37,37,5,;		7,17,11,3,33,28,37,5,25,;		17,11,27,33,28,13,5,25,34,;		11,27,4,28,13,13,25,34,47,;		27,4,39,13,13,18,34,47,1,;		4,39,34,13,18,17,47,1,26,;		39,34,31,18,17,20,1,26,7,;		34,31,19,17,20,36,26,7,12,;		31,19,3,20,36,27,7,12,12,;		19,3,18,36,27,45,12,12,41,;		3,18,4,27,45,17,12,41,24,;		18,4,26,45,17,17,41,24,2,;		4,26,7,17,17,9,24,2,28,;		26,7,32,17,9,7,2,28,16,;		7,32,50,9,7,25,28,16,13,;		32,50,10,7,25,39,16,13,29,;		50,10,38,25,39,7,13,29,13,;		10,38,10,39,7,23,29,13,46,;		38,10,33,7,23,13,13,46,46,;		10,33,4,23,13,1,46,46,7,;		33,4,34,13,1,33,46,7,45,;		
12,24,15,3,30,37,34,24,49,;		24,15,3,30,37,37,24,49,22,;		15,3,33,37,37,5,49,22,49,;		3,33,28,37,5,25,22,49,14,;		33,28,13,5,25,34,49,14,7,;		28,13,13,25,34,47,14,7,17,;		13,13,18,34,47,1,7,17,21,;		13,18,17,47,1,26,17,21,26,;		18,17,20,1,26,7,21,26,43,;		17,20,36,26,7,12,26,43,49,;		20,36,27,7,12,12,43,49,25,;		36,27,45,12,12,41,49,25,35,;		27,45,17,12,41,24,25,35,18,;		45,17,17,41,24,2,35,18,3,;		17,17,9,24,2,28,18,3,45,;		17,9,7,2,28,16,3,45,19,;		9,7,25,28,16,13,45,19,12,;		7,25,39,16,13,29,19,12,20,;		25,39,7,13,29,13,12,20,43,;		39,7,23,29,13,46,20,43,29,;		7,23,13,13,46,46,43,29,37,;		23,13,1,46,46,7,29,37,40,;		13,1,33,46,7,45,37,40,37,;		
3,30,37,34,24,49,24,40,40,;		30,37,37,24,49,22,40,40,9,;		37,37,5,49,22,49,40,9,5,;		37,5,25,22,49,14,9,5,19,;		5,25,34,49,14,7,5,19,28,;		25,34,47,14,7,17,19,28,46,;		34,47,1,7,17,21,28,46,1,;		47,1,26,17,21,26,46,1,19,;		1,26,7,21,26,43,1,19,1,;		26,7,12,26,43,49,19,1,16,;		7,12,12,43,49,25,1,16,31,;		12,12,41,49,25,35,16,31,33,;		12,41,24,25,35,18,31,33,30,;		41,24,2,35,18,3,33,30,44,;		24,2,28,18,3,45,30,44,43,;		2,28,16,3,45,19,44,43,20,;		28,16,13,45,19,12,43,20,39,;		16,13,29,19,12,20,20,39,48,;		13,29,13,12,20,43,39,48,13,;		29,13,46,20,43,29,48,13,19,;		13,46,46,43,29,37,13,19,19,;		46,46,7,29,37,40,19,19,34,;		46,7,45,37,40,37,19,34,42,;		
34,24,49,24,40,40,31,39,41,;		24,49,22,40,40,9,39,41,49,;		49,22,49,40,9,5,41,49,42,;		22,49,14,9,5,19,49,42,7,;		49,14,7,5,19,28,42,7,25,;		14,7,17,19,28,46,7,25,39,;		7,17,21,28,46,1,25,39,18,;		17,21,26,46,1,19,39,18,46,;		21,26,43,1,19,1,18,46,32,;		26,43,49,19,1,16,46,32,7,;		43,49,25,1,16,31,32,7,38,;		49,25,35,16,31,33,7,38,1,;		25,35,18,31,33,30,38,1,20,;		35,18,3,33,30,44,1,20,19,;		18,3,45,30,44,43,20,19,3,;		3,45,19,44,43,20,19,3,10,;		45,19,12,43,20,39,3,10,18,;		19,12,20,20,39,48,10,18,28,;		12,20,43,39,48,13,18,28,27,;		20,43,29,48,13,19,28,27,16,;		43,29,37,13,19,19,27,16,29,;		29,37,40,19,19,34,16,29,1,;		37,40,37,19,34,42,29,1,2,;		
24,40,40,31,39,41,25,32,33,;		40,40,9,39,41,49,32,33,9,;		40,9,5,41,49,42,33,9,14,;		9,5,19,49,42,7,9,14,23,;		5,19,28,42,7,25,14,23,34,;		19,28,46,7,25,39,23,34,44,;		28,46,1,25,39,18,34,44,30,;		46,1,19,39,18,46,44,30,7,;		1,19,1,18,46,32,30,7,47,;		19,1,16,46,32,7,7,47,34,;		1,16,31,32,7,38,47,34,3,;		16,31,33,7,38,1,34,3,7,;		31,33,30,38,1,20,3,7,21,;		33,30,44,1,20,19,7,21,42,;		30,44,43,20,19,3,21,42,20,;		44,43,20,19,3,10,42,20,22,;		43,20,39,3,10,18,20,22,30,;		20,39,48,10,18,28,22,30,7,;		39,48,13,18,28,27,30,7,23,;		48,13,19,28,27,16,7,23,42,;		13,19,19,27,16,29,23,42,6,;		19,19,34,16,29,1,42,6,3,;		19,34,42,29,1,2,6,3,7,;		
31,39,41,25,32,33,47,42,46,;		39,41,49,32,33,9,42,46,19,;		41,49,42,33,9,14,46,19,4,;		49,42,7,9,14,23,19,4,22,;		42,7,25,14,23,34,4,22,42,;		7,25,39,23,34,44,22,42,20,;		25,39,18,34,44,30,42,20,48,;		39,18,46,44,30,7,20,48,5,;		18,46,32,30,7,47,48,5,33,;		46,32,7,7,47,34,5,33,43,;		32,7,38,47,34,3,33,43,9,;		7,38,1,34,3,7,43,9,35,;		38,1,20,3,7,21,9,35,43,;		1,20,19,7,21,42,35,43,45,;		20,19,3,21,42,20,43,45,5,;		19,3,10,42,20,22,45,5,3,;		3,10,18,20,22,30,5,3,44,;		10,18,28,22,30,7,3,44,13,;		18,28,27,30,7,23,44,13,24,;		28,27,16,7,23,42,13,24,25,;		27,16,29,23,42,6,24,25,22,;		16,29,1,42,6,3,25,22,4,;		29,1,2,6,3,7,22,4,15,;		
25,32,33,47,42,46,18,4,47,;		32,33,9,42,46,19,4,47,5,;		33,9,14,46,19,4,47,5,40,;		9,14,23,19,4,22,5,40,45,;		14,23,34,4,22,42,40,45,42,;		23,34,44,22,42,20,45,42,28,;		34,44,30,42,20,48,42,28,14,;		44,30,7,20,48,5,28,14,29,;		30,7,47,48,5,33,14,29,38,;		7,47,34,5,33,43,29,38,20,;		47,34,3,33,43,9,38,20,1,;		34,3,7,43,9,35,20,1,35,;		3,7,21,9,35,43,1,35,13,;		7,21,42,35,43,45,35,13,32,;		21,42,20,43,45,5,13,32,19,;		42,20,22,45,5,3,32,19,9,;		20,22,30,5,3,44,19,9,28,;		22,30,7,3,44,13,9,28,38,;		30,7,23,44,13,24,28,38,18,;		7,23,42,13,24,25,38,18,33,;		23,42,6,24,25,22,18,33,31,;		42,6,3,25,22,4,33,31,19,;		6,3,7,22,4,15,31,19,37,;		
47,42,46,18,4,47,6,11,12,;		42,46,19,4,47,5,11,12,7,;		46,19,4,47,5,40,12,7,9,;		19,4,22,5,40,45,7,9,10,;		4,22,42,40,45,42,9,10,15,;		22,42,20,45,42,28,10,15,37,;		42,20,48,42,28,14,15,37,33,;		20,48,5,28,14,29,37,33,25,;		48,5,33,14,29,38,33,25,39,;		5,33,43,29,38,20,25,39,24,;		33,43,9,38,20,1,39,24,44,;		43,9,35,20,1,35,24,44,35,;		9,35,43,1,35,13,44,35,17,;		35,43,45,35,13,32,35,17,43,;		43,45,5,13,32,19,17,43,25,;		45,5,3,32,19,9,43,25,34,;		5,3,44,19,9,28,25,34,41,;		3,44,13,9,28,38,34,41,36,;		44,13,24,28,38,18,41,36,3,;		13,24,25,38,18,33,36,3,26,;		24,25,22,18,33,31,3,26,25,;		25,22,4,33,31,19,26,25,6,;		22,4,15,31,19,37,25,6,25,;		
18,4,47,6,11,12,18,21,19,;		4,47,5,11,12,7,21,19,7,;		47,5,40,12,7,9,19,7,6,;		5,40,45,7,9,10,7,6,10,;		40,45,42,9,10,15,6,10,45,;		45,42,28,10,15,37,10,45,27,;		42,28,14,15,37,33,45,27,23,;		28,14,29,37,33,25,27,23,39,;		14,29,38,33,25,39,23,39,41,;		29,38,20,25,39,24,39,41,48,;		38,20,1,39,24,44,41,48,36,;		20,1,35,24,44,35,48,36,39,;		1,35,13,44,35,17,36,39,11,;		35,13,32,35,17,43,39,11,49,;		13,32,19,17,43,25,11,49,29,;		32,19,9,43,25,34,49,29,13,;		19,9,28,25,34,41,29,13,9,;		9,28,38,34,41,36,13,9,39,;		28,38,18,41,36,3,9,39,7,;		38,18,33,36,3,26,39,7,27,;		18,33,31,3,26,25,7,27,4,;		33,31,19,26,25,6,27,4,10,;		31,19,37,25,6,25,4,10,8,;		
6,11,12,18,21,19,30,39,3,;		11,12,7,21,19,7,39,3,26,;		12,7,9,19,7,6,3,26,33,;		7,9,10,7,6,10,26,33,50,;		9,10,15,6,10,45,33,50,17,;		10,15,37,10,45,27,50,17,47,;		15,37,33,45,27,23,17,47,3,;		37,33,25,27,23,39,47,3,15,;		33,25,39,23,39,41,3,15,18,;		25,39,24,39,41,48,15,18,39,;		39,24,44,41,48,36,18,39,27,;		24,44,35,48,36,39,39,27,3,;		44,35,17,36,39,11,27,3,8,;		35,17,43,39,11,49,3,8,30,;		17,43,25,11,49,29,8,30,25,;		43,25,34,49,29,13,30,25,4,;		25,34,41,29,13,9,25,4,43,;		34,41,36,13,9,39,4,43,5,;		41,36,3,9,39,7,43,5,21,;		36,3,26,39,7,27,5,21,11,;		3,26,25,7,27,4,21,11,36,;		26,25,6,27,4,10,11,36,47,;		25,6,25,4,10,8,36,47,25,;		
18,21,19,30,39,3,49,30,31,;		21,19,7,39,3,26,30,31,5,;		19,7,6,3,26,33,31,5,42,;		7,6,10,26,33,50,5,42,34,;		6,10,45,33,50,17,42,34,5,;		10,45,27,50,17,47,34,5,39,;		45,27,23,17,47,3,5,39,36,;		27,23,39,47,3,15,39,36,15,;		23,39,41,3,15,18,36,15,15,;		39,41,48,15,18,39,15,15,8,;		41,48,36,18,39,27,15,8,5,;		48,36,39,39,27,3,8,5,9,;		36,39,11,27,3,8,5,9,31,;		39,11,49,3,8,30,9,31,48,;		11,49,29,8,30,25,31,48,31,;		49,29,13,30,25,4,48,31,43,;		29,13,9,25,4,43,31,43,14,;		13,9,39,4,43,5,43,14,46,;		9,39,7,43,5,21,14,46,6,;		39,7,27,5,21,11,46,6,16,;		7,27,4,21,11,36,6,16,8,;		27,4,10,11,36,47,16,8,13,;		4,10,8,36,47,25,8,13,42,;		
30,39,3,49,30,31,47,22,24,;		39,3,26,30,31,5,22,24,41,;		3,26,33,31,5,42,24,41,35,;		26,33,50,5,42,34,41,35,20,;		33,50,17,42,34,5,35,20,9,;		50,17,47,34,5,39,20,9,25,;		17,47,3,5,39,36,9,25,19,;		47,3,15,39,36,15,25,19,11,;		3,15,18,36,15,15,19,11,15,;		15,18,39,15,15,8,11,15,19,;		18,39,27,15,8,5,15,19,31,;		39,27,3,8,5,9,19,31,36,;		27,3,8,5,9,31,31,36,15,;		3,8,30,9,31,48,36,15,4,;		8,30,25,31,48,31,15,4,29,;		30,25,4,48,31,43,4,29,49,;		25,4,43,31,43,14,29,49,33,;		4,43,5,43,14,46,49,33,32,;		43,5,21,14,46,6,33,32,9,;		5,21,11,46,6,16,32,9,14,;		21,11,36,6,16,8,9,14,18,;		11,36,47,16,8,13,14,18,41,;		36,47,25,8,13,42,18,41,6,;		
49,30,31,47,22,24,14,40,37,;		30,31,5,22,24,41,40,37,40,;		31,5,42,24,41,35,37,40,38,;		5,42,34,41,35,20,40,38,3,;		42,34,5,35,20,9,38,3,42,;		34,5,39,20,9,25,3,42,48,;		5,39,36,9,25,19,42,48,17,;		39,36,15,25,19,11,48,17,35,;		36,15,15,19,11,15,17,35,1,;		15,15,8,11,15,19,35,1,39,;		15,8,5,15,19,31,1,39,10,;		8,5,9,19,31,36,39,10,42,;		5,9,31,31,36,15,10,42,3,;		9,31,48,36,15,4,42,3,18,;		31,48,31,15,4,29,3,18,25,;		48,31,43,4,29,49,18,25,12,;		31,43,14,29,49,33,25,12,44,;		43,14,46,49,33,32,12,44,28,;		14,46,6,33,32,9,44,28,39,;		46,6,16,32,9,14,28,39,43,;		6,16,8,9,14,18,39,43,45,;		16,8,13,14,18,41,43,45,28,;		8,13,42,18,41,6,45,28,21,;		
47,22,24,14,40,37,33,23,44,;		22,24,41,40,37,40,23,44,33,;		24,41,35,37,40,38,44,33,21,;		41,35,20,40,38,3,33,21,13,;		35,20,9,38,3,42,21,13,32,;		20,9,25,3,42,48,13,32,43,;		9,25,19,42,48,17,32,43,9,;		25,19,11,48,17,35,43,9,48,;		19,11,15,17,35,1,9,48,33,;		11,15,19,35,1,39,48,33,5,;		15,19,31,1,39,10,33,5,7,;		19,31,36,39,10,42,5,7,5,;		31,36,15,10,42,3,7,5,16,;		36,15,4,42,3,18,5,16,12,;		15,4,29,3,18,25,16,12,37,;		4,29,49,18,25,12,12,37,5,;		29,49,33,25,12,44,37,5,41,;		49,33,32,12,44,28,5,41,29,;		33,32,9,44,28,39,41,29,26,;		32,9,14,28,39,43,29,26,45,;		9,14,18,39,43,45,26,45,1,;		14,18,41,43,45,28,45,1,33,;		18,41,6,45,28,21,1,33,14,;		
14,40,37,33,23,44,27,34,41,;		40,37,40,23,44,33,34,41,50,;		37,40,38,44,33,21,41,50,42,;		40,38,3,33,21,13,50,42,18,;		38,3,42,21,13,32,42,18,13,;		3,42,48,13,32,43,18,13,47,;		42,48,17,32,43,9,13,47,15,;		48,17,35,43,9,48,47,15,8,;		17,35,1,9,48,33,15,8,43,;		35,1,39,48,33,5,8,43,3,;		1,39,10,33,5,7,43,3,29,;		39,10,42,5,7,5,3,29,29,;		10,42,3,7,5,16,29,29,7,;		42,3,18,5,16,12,29,7,41,;		3,18,25,16,12,37,7,41,34,;		18,25,12,12,37,5,41,34,35,;		25,12,44,37,5,41,34,35,11,;		12,44,28,5,41,29,35,11,31,;		44,28,39,41,29,26,11,31,14,;		28,39,43,29,26,45,31,14,26,;		39,43,45,26,45,1,14,26,1,;		43,45,28,45,1,33,26,1,30,;		45,28,21,1,33,14,1,30,29,;		
33,23,44,27,34,41,5,6,13,;		23,44,33,34,41,50,6,13,33,;		44,33,21,41,50,42,13,33,34,;		33,21,13,50,42,18,33,34,13,;		21,13,32,42,18,13,34,13,7,;		13,32,43,18,13,47,13,7,3,;		32,43,9,13,47,15,7,3,35,;		43,9,48,47,15,8,3,35,5,;		9,48,33,15,8,43,35,5,14,;		48,33,5,8,43,3,5,14,22,;		33,5,7,43,3,29,14,22,19,;		5,7,5,3,29,29,22,19,10,;		7,5,16,29,29,7,19,10,40,;		5,16,12,29,7,41,10,40,8,;		16,12,37,7,41,34,40,8,43,;		12,37,5,41,34,35,8,43,7,;		37,5,41,34,35,11,43,7,13,;		5,41,29,35,11,31,7,13,39,;		41,29,26,11,31,14,13,39,5,;		29,26,45,31,14,26,39,5,18,;		26,45,1,14,26,1,5,18,7,;		45,1,33,26,1,30,18,7,35,;		1,33,14,1,30,29,7,35,25,;		


42,50,29,13,28,30,13,26,29,;		50,29,21,28,30,31,26,29,49,;		29,21,13,30,31,45,29,49,10,;		21,13,37,31,45,40,49,10,22,;		13,37,7,45,40,7,10,22,9,;		37,7,29,40,7,21,22,9,7,;		7,29,16,7,21,5,9,7,16,;		29,16,31,21,5,14,7,16,5,;		16,31,19,5,14,36,16,5,11,;		31,19,49,14,36,47,5,11,44,;		19,49,22,36,47,49,11,44,28,;		49,22,2,47,49,5,44,28,4,;		22,2,33,49,5,13,28,4,10,;		2,33,27,5,13,10,4,10,21,;		33,27,11,13,10,22,10,21,11,;		27,11,29,10,22,43,21,11,33,;		11,29,4,22,43,9,11,33,48,;		29,4,3,43,9,46,33,48,12,;		4,3,17,9,46,23,48,12,38,;		3,17,7,46,23,1,12,38,14,;		17,7,2,23,1,46,38,14,1,;		7,2,3,1,46,14,14,1,10,;		2,3,23,46,14,14,1,10,15,;		
13,28,30,13,26,29,33,17,33,;		28,30,31,26,29,49,17,33,39,;		30,31,45,29,49,10,33,39,19,;		31,45,40,49,10,22,39,19,49,;		45,40,7,10,22,9,19,49,6,;		40,7,21,22,9,7,49,6,23,;		7,21,5,9,7,16,6,23,32,;		21,5,14,7,16,5,23,32,26,;		5,14,36,16,5,11,32,26,14,;		14,36,47,5,11,44,26,14,39,;		36,47,49,11,44,28,14,39,11,;		47,49,5,44,28,4,39,11,27,;		49,5,13,28,4,10,11,27,20,;		5,13,10,4,10,21,27,20,13,;		13,10,22,10,21,11,20,13,43,;		10,22,43,21,11,33,13,43,3,;		22,43,9,11,33,48,43,3,19,;		43,9,46,33,48,12,3,19,34,;		9,46,23,48,12,38,19,34,49,;		46,23,1,12,38,14,34,49,19,;		23,1,46,38,14,1,49,19,31,;		1,46,14,14,1,10,19,31,30,;		46,14,14,1,10,15,31,30,33,;		
13,26,29,33,17,33,47,7,7,;		26,29,49,17,33,39,7,7,9,;		29,49,10,33,39,19,7,9,45,;		49,10,22,39,19,49,9,45,34,;		10,22,9,19,49,6,45,34,48,;		22,9,7,49,6,23,34,48,39,;		9,7,16,6,23,32,48,39,5,;		7,16,5,23,32,26,39,5,25,;		16,5,11,32,26,14,5,25,2,;		5,11,44,26,14,39,25,2,42,;		11,44,28,14,39,11,2,42,3,;		44,28,4,39,11,27,42,3,30,;		28,4,10,11,27,20,3,30,44,;		4,10,21,27,20,13,30,44,24,;		10,21,11,20,13,43,44,24,15,;		21,11,33,13,43,3,24,15,7,;		11,33,48,43,3,19,15,7,43,;		33,48,12,3,19,34,7,43,36,;		48,12,38,19,34,49,43,36,10,;		12,38,14,34,49,19,36,10,45,;		38,14,1,49,19,31,10,45,2,;		14,1,10,19,31,30,45,2,34,;		1,10,15,31,30,33,2,34,11,;		
33,17,33,47,7,7,49,1,47,;		17,33,39,7,7,9,1,47,39,;		33,39,19,7,9,45,47,39,43,;		39,19,49,9,45,34,39,43,48,;		19,49,6,45,34,48,43,48,25,;		49,6,23,34,48,39,48,25,18,;		6,23,32,48,39,5,25,18,20,;		23,32,26,39,5,25,18,20,18,;		32,26,14,5,25,2,20,18,15,;		26,14,39,25,2,42,18,15,34,;		14,39,11,2,42,3,15,34,9,;		39,11,27,42,3,30,34,9,46,;		11,27,20,3,30,44,9,46,47,;		27,20,13,30,44,24,46,47,47,;		20,13,43,44,24,15,47,47,21,;		13,43,3,24,15,7,47,21,28,;		43,3,19,15,7,43,21,28,29,;		3,19,34,7,43,36,28,29,41,;		19,34,49,43,36,10,29,41,21,;		34,49,19,36,10,45,41,21,4,;		49,19,31,10,45,2,21,4,23,;		19,31,30,45,2,34,4,23,18,;		31,30,33,2,34,11,23,18,37,;		
47,7,7,49,1,47,8,14,16,;		7,7,9,1,47,39,14,16,17,;		7,9,45,47,39,43,16,17,25,;		9,45,34,39,43,48,17,25,40,;		45,34,48,43,48,25,25,40,25,;		34,48,39,48,25,18,40,25,47,;		48,39,5,25,18,20,25,47,28,;		39,5,25,18,20,18,47,28,50,;		5,25,2,20,18,15,28,50,6,;		25,2,42,18,15,34,50,6,6,;		2,42,3,15,34,9,6,6,28,;		42,3,30,34,9,46,6,28,8,;		3,30,44,9,46,47,28,8,34,;		30,44,24,46,47,47,8,34,32,;		44,24,15,47,47,21,34,32,10,;		24,15,7,47,21,28,32,10,28,;		15,7,43,21,28,29,10,28,44,;		7,43,36,28,29,41,28,44,48,;		43,36,10,29,41,21,44,48,31,;		36,10,45,41,21,4,48,31,47,;		10,45,2,21,4,23,31,47,10,;		45,2,34,4,23,18,47,10,13,;		2,34,11,23,18,37,10,13,12,;		
49,1,47,8,14,16,46,16,50,;		1,47,39,14,16,17,16,50,29,;		47,39,43,16,17,25,50,29,14,;		39,43,48,17,25,40,29,14,3,;		43,48,25,25,40,25,14,3,22,;		48,25,18,40,25,47,3,22,20,;		25,18,20,25,47,28,22,20,27,;		18,20,18,47,28,50,20,27,26,;		20,18,15,28,50,6,27,26,36,;		18,15,34,50,6,6,26,36,5,;		15,34,9,6,6,28,36,5,1,;		34,9,46,6,28,8,5,1,41,;		9,46,47,28,8,34,1,41,38,;		46,47,47,8,34,32,41,38,4,;		47,47,21,34,32,10,38,4,41,;		47,21,28,32,10,28,4,41,30,;		21,28,29,10,28,44,41,30,21,;		28,29,41,28,44,48,30,21,2,;		29,41,21,44,48,31,21,2,14,;		41,21,4,48,31,47,2,14,43,;		21,4,23,31,47,10,14,43,49,;		4,23,18,47,10,13,43,49,2,;		23,18,37,10,13,12,49,2,28,;		
8,14,16,46,16,50,7,33,29,;		14,16,17,16,50,29,33,29,35,;		16,17,25,50,29,14,29,35,12,;		17,25,40,29,14,3,35,12,16,;		25,40,25,14,3,22,12,16,17,;		40,25,47,3,22,20,16,17,8,;		25,47,28,22,20,27,17,8,5,;		47,28,50,20,27,26,8,5,22,;		28,50,6,27,26,36,5,22,39,;		50,6,6,26,36,5,22,39,14,;		6,6,28,36,5,1,39,14,16,;		6,28,8,5,1,41,14,16,49,;		28,8,34,1,41,38,16,49,41,;		8,34,32,41,38,4,49,41,16,;		34,32,10,38,4,41,41,16,29,;		32,10,28,4,41,30,16,29,29,;		10,28,44,41,30,21,29,29,21,;		28,44,48,30,21,2,29,21,11,;		44,48,31,21,2,14,21,11,22,;		48,31,47,2,14,43,11,22,30,;		31,47,10,14,43,49,22,30,2,;		47,10,13,43,49,2,30,2,47,;		10,13,12,49,2,28,2,47,24,;		
46,16,50,7,33,29,4,50,37,;		16,50,29,33,29,35,50,37,36,;		50,29,14,29,35,12,37,36,6,;		29,14,3,35,12,16,36,6,22,;		14,3,22,12,16,17,6,22,15,;		3,22,20,16,17,8,22,15,15,;		22,20,27,17,8,5,15,15,36,;		20,27,26,8,5,22,15,36,1,;		27,26,36,5,22,39,36,1,38,;		26,36,5,22,39,14,1,38,9,;		36,5,1,39,14,16,38,9,44,;		5,1,41,14,16,49,9,44,11,;		1,41,38,16,49,41,44,11,19,;		41,38,4,49,41,16,11,19,32,;		38,4,41,41,16,29,19,32,14,;		4,41,30,16,29,29,32,14,23,;		41,30,21,29,29,21,14,23,23,;		30,21,2,29,21,11,23,23,1,;		21,2,14,21,11,22,23,1,12,;		2,14,43,11,22,30,1,12,47,;		14,43,49,22,30,2,12,47,48,;		43,49,2,30,2,47,47,48,13,;		49,2,28,2,47,24,48,13,18,;		
7,33,29,4,50,37,24,48,32,;		33,29,35,50,37,36,48,32,36,;		29,35,12,37,36,6,32,36,10,;		35,12,16,36,6,22,36,10,3,;		12,16,17,6,22,15,10,3,5,;		16,17,8,22,15,15,3,5,7,;		17,8,5,15,15,36,5,7,5,;		8,5,22,15,36,1,7,5,3,;		5,22,39,36,1,38,5,3,39,;		22,39,14,1,38,9,3,39,10,;		39,14,16,38,9,44,39,10,30,;		14,16,49,9,44,11,10,30,40,;		16,49,41,44,11,19,30,40,34,;		49,41,16,11,19,32,40,34,27,;		41,16,29,19,32,14,34,27,16,;		16,29,29,32,14,23,27,16,23,;		29,29,21,14,23,23,16,23,10,;		29,21,11,23,23,1,23,10,10,;		21,11,22,23,1,12,10,10,6,;		11,22,30,1,12,47,10,6,26,;		22,30,2,12,47,48,6,26,14,;		30,2,47,47,48,13,26,14,23,;		2,47,24,48,13,18,14,23,22,;		
4,50,37,24,48,32,22,20,31,;		50,37,36,48,32,36,20,31,32,;		37,36,6,32,36,10,31,32,26,;		36,6,22,36,10,3,32,26,10,;		6,22,15,10,3,5,26,10,50,;		22,15,15,3,5,7,10,50,41,;		15,15,36,5,7,5,50,41,1,;		15,36,1,7,5,3,41,1,43,;		36,1,38,5,3,39,1,43,49,;		1,38,9,3,39,10,43,49,14,;		38,9,44,39,10,30,49,14,32,;		9,44,11,10,30,40,14,32,14,;		44,11,19,30,40,34,32,14,13,;		11,19,32,40,34,27,14,13,47,;		19,32,14,34,27,16,13,47,7,;		32,14,23,27,16,23,47,7,16,;		14,23,23,16,23,10,7,16,9,;		23,23,1,23,10,10,16,9,21,;		23,1,12,10,10,6,9,21,24,;		1,12,47,10,6,26,21,24,10,;		12,47,48,6,26,14,24,10,34,;		47,48,13,26,14,23,10,34,48,;		48,13,18,14,23,22,34,48,11,;		
24,48,32,22,20,31,39,49,18,;		48,32,36,20,31,32,49,18,42,;		32,36,10,31,32,26,18,42,22,;		36,10,3,32,26,10,42,22,35,;		10,3,5,26,10,50,22,35,44,;		3,5,7,10,50,41,35,44,24,;		5,7,5,50,41,1,44,24,15,;		7,5,3,41,1,43,24,15,20,;		5,3,39,1,43,49,15,20,41,;		3,39,10,43,49,14,20,41,20,;		39,10,30,49,14,32,41,20,6,;		10,30,40,14,32,14,20,6,27,;		30,40,34,32,14,13,6,27,9,;		40,34,27,14,13,47,27,9,33,;		34,27,16,13,47,7,9,33,31,;		27,16,23,47,7,16,33,31,35,;		16,23,10,7,16,9,31,35,32,;		23,10,10,16,9,21,35,32,6,;		10,10,6,9,21,24,32,6,43,;		10,6,26,21,24,10,6,43,26,;		6,26,14,24,10,34,43,26,15,;		26,14,23,10,34,48,26,15,20,;		14,23,22,34,48,11,15,20,9,;		
22,20,31,39,49,18,31,19,36,;		20,31,32,49,18,42,19,36,26,;		31,32,26,18,42,22,36,26,17,;		32,26,10,42,22,35,26,17,39,;		26,10,50,22,35,44,17,39,13,;		10,50,41,35,44,24,39,13,10,;		50,41,1,44,24,15,13,10,33,;		41,1,43,24,15,20,10,33,31,;		1,43,49,15,20,41,33,31,13,;		43,49,14,20,41,20,31,13,49,;		49,14,32,41,20,6,13,49,47,;		14,32,14,20,6,27,49,47,10,;		32,14,13,6,27,9,47,10,1,;		14,13,47,27,9,33,10,1,43,;		13,47,7,9,33,31,1,43,6,;		47,7,16,33,31,35,43,6,9,;		7,16,9,31,35,32,6,9,36,;		16,9,21,35,32,6,9,36,16,;		9,21,24,32,6,43,36,16,36,;		21,24,10,6,43,26,16,36,32,;		24,10,34,43,26,15,36,32,23,;		10,34,48,26,15,20,32,23,2,;		34,48,11,15,20,9,23,2,21,;		
39,49,18,31,19,36,17,10,45,;		49,18,42,19,36,26,10,45,42,;		18,42,22,36,26,17,45,42,8,;		42,22,35,26,17,39,42,8,41,;		22,35,44,17,39,13,8,41,48,;		35,44,24,39,13,10,41,48,7,;		44,24,15,13,10,33,48,7,24,;		24,15,20,10,33,31,7,24,37,;		15,20,41,33,31,13,24,37,32,;		20,41,20,31,13,49,37,32,35,;		41,20,6,13,49,47,32,35,39,;		20,6,27,49,47,10,35,39,14,;		6,27,9,47,10,1,39,14,36,;		27,9,33,10,1,43,14,36,47,;		9,33,31,1,43,6,36,47,23,;		33,31,35,43,6,9,47,23,50,;		31,35,32,6,9,36,23,50,39,;		35,32,6,9,36,16,50,39,46,;		32,6,43,36,16,36,39,46,39,;		6,43,26,16,36,32,46,39,16,;		43,26,15,36,32,23,39,16,1,;		26,15,20,32,23,2,16,1,41,;		15,20,9,23,2,21,1,41,39,;		
31,19,36,17,10,45,36,48,22,;		19,36,26,10,45,42,48,22,10,;		36,26,17,45,42,8,22,10,12,;		26,17,39,42,8,41,10,12,44,;		17,39,13,8,41,48,12,44,36,;		39,13,10,41,48,7,44,36,9,;		13,10,33,48,7,24,36,9,19,;		10,33,31,7,24,37,9,19,20,;		33,31,13,24,37,32,19,20,31,;		31,13,49,37,32,35,20,31,20,;		13,49,47,32,35,39,31,20,20,;		49,47,10,35,39,14,20,20,10,;		47,10,1,39,14,36,20,10,11,;		10,1,43,14,36,47,10,11,39,;		1,43,6,36,47,23,11,39,21,;		43,6,9,47,23,50,39,21,23,;		6,9,36,23,50,39,21,23,8,;		9,36,16,50,39,46,23,8,25,;		36,16,36,39,46,39,8,25,17,;		16,36,32,46,39,16,25,17,30,;		36,32,23,39,16,1,17,30,32,;		32,23,2,16,1,41,30,32,21,;		23,2,21,1,41,39,32,21,15,;		
17,10,45,36,48,22,13,45,21,;		10,45,42,48,22,10,45,21,8,;		45,42,8,22,10,12,21,8,29,;		42,8,41,10,12,44,8,29,44,;		8,41,48,12,44,36,29,44,46,;		41,48,7,44,36,9,44,46,44,;		48,7,24,36,9,19,46,44,16,;		7,24,37,9,19,20,44,16,49,;		24,37,32,19,20,31,16,49,28,;		37,32,35,20,31,20,49,28,22,;		32,35,39,31,20,20,28,22,31,;		35,39,14,20,20,10,22,31,33,;		39,14,36,20,10,11,31,33,33,;		14,36,47,10,11,39,33,33,34,;		36,47,23,11,39,21,33,34,28,;		47,23,50,39,21,23,34,28,41,;		23,50,39,21,23,8,28,41,44,;		50,39,46,23,8,25,41,44,48,;		39,46,39,8,25,17,44,48,15,;		46,39,16,25,17,30,48,15,25,;		39,16,1,17,30,32,15,25,31,;		16,1,41,30,32,21,25,31,26,;		1,41,39,32,21,15,31,26,28,;		
36,48,22,13,45,21,49,23,37,;		48,22,10,45,21,8,23,37,29,;		22,10,12,21,8,29,37,29,45,;		10,12,44,8,29,44,29,45,20,;		12,44,36,29,44,46,45,20,18,;		44,36,9,44,46,44,20,18,25,;		36,9,19,46,44,16,18,25,15,;		9,19,20,44,16,49,25,15,21,;		19,20,31,16,49,28,15,21,7,;		20,31,20,49,28,22,21,7,26,;		31,20,20,28,22,31,7,26,36,;		20,20,10,22,31,33,26,36,1,;		20,10,11,31,33,33,36,1,49,;		10,11,39,33,33,34,1,49,21,;		11,39,21,33,34,28,49,21,49,;		39,21,23,34,28,41,21,49,28,;		21,23,8,28,41,44,49,28,18,;		23,8,25,41,44,48,28,18,29,;		8,25,17,44,48,15,18,29,7,;		25,17,30,48,15,25,29,7,5,;		17,30,32,15,25,31,7,5,18,;		30,32,21,25,31,26,5,18,41,;		32,21,15,31,26,28,18,41,34,;		
13,45,21,49,23,37,12,39,17,;		45,21,8,23,37,29,39,17,25,;		21,8,29,37,29,45,17,25,32,;		8,29,44,29,45,20,25,32,32,;		29,44,46,45,20,18,32,32,36,;		44,46,44,20,18,25,32,36,21,;		46,44,16,18,25,15,36,21,46,;		44,16,49,25,15,21,21,46,44,;		16,49,28,15,21,7,46,44,45,;		49,28,22,21,7,26,44,45,47,;		28,22,31,7,26,36,45,47,30,;		22,31,33,26,36,1,47,30,43,;		31,33,33,36,1,49,30,43,32,;		33,33,34,1,49,21,43,32,26,;		33,34,28,49,21,49,32,26,32,;		34,28,41,21,49,28,26,32,8,;		28,41,44,49,28,18,32,8,10,;		41,44,48,28,18,29,8,10,40,;		44,48,15,18,29,7,10,40,30,;		48,15,25,29,7,5,40,30,43,;		15,25,31,7,5,18,30,43,39,;		25,31,26,5,18,41,43,39,49,;		31,26,28,18,41,34,39,49,5,;		
49,23,37,12,39,17,39,4,31,;		23,37,29,39,17,25,4,31,21,;		37,29,45,17,25,32,31,21,21,;		29,45,20,25,32,32,21,21,44,;		45,20,18,32,32,36,21,44,35,;		20,18,25,32,36,21,44,35,31,;		18,25,15,36,21,46,35,31,24,;		25,15,21,21,46,44,31,24,6,;		15,21,7,46,44,45,24,6,8,;		21,7,26,44,45,47,6,8,33,;		7,26,36,45,47,30,8,33,26,;		26,36,1,47,30,43,33,26,15,;		36,1,49,30,43,32,26,15,24,;		1,49,21,43,32,26,15,24,26,;		49,21,49,32,26,32,24,26,44,;		21,49,28,26,32,8,26,44,5,;		49,28,18,32,8,10,44,5,50,;		28,18,29,8,10,40,5,50,44,;		18,29,7,10,40,30,50,44,14,;		29,7,5,40,30,43,44,14,11,;		7,5,18,30,43,39,14,11,10,;		5,18,41,43,39,49,11,10,30,;		18,41,34,39,49,5,10,30,13,;		
12,39,17,39,4,31,11,39,15,;		39,17,25,4,31,21,39,15,43,;		17,25,32,31,21,21,15,43,24,;		25,32,32,21,21,44,43,24,49,;		32,32,36,21,44,35,24,49,20,;		32,36,21,44,35,31,49,20,30,;		36,21,46,35,31,24,20,30,2,;		21,46,44,31,24,6,30,2,34,;		46,44,45,24,6,8,2,34,15,;		44,45,47,6,8,33,34,15,8,;		45,47,30,8,33,26,15,8,35,;		47,30,43,33,26,15,8,35,27,;		30,43,32,26,15,24,35,27,20,;		43,32,26,15,24,26,27,20,10,;		32,26,32,24,26,44,20,10,35,;		26,32,8,26,44,5,10,35,10,;		32,8,10,44,5,50,35,10,19,;		8,10,40,5,50,44,10,19,50,;		10,40,30,50,44,14,19,50,47,;		40,30,43,44,14,11,50,47,26,;		30,43,39,14,11,10,47,26,42,;		43,39,49,11,10,30,26,42,47,;		39,49,5,10,30,13,42,47,22,;		
39,4,31,11,39,15,9,21,24,;		4,31,21,39,15,43,21,24,49,;		31,21,21,15,43,24,24,49,50,;		21,21,44,43,24,49,49,50,2,;		21,44,35,24,49,20,50,2,38,;		44,35,31,49,20,30,2,38,16,;		35,31,24,20,30,2,38,16,15,;		31,24,6,30,2,34,16,15,33,;		24,6,8,2,34,15,15,33,13,;		6,8,33,34,15,8,33,13,32,;		8,33,26,15,8,35,13,32,34,;		33,26,15,8,35,27,32,34,46,;		26,15,24,35,27,20,34,46,2,;		15,24,26,27,20,10,46,2,3,;		24,26,44,20,10,35,2,3,12,;		26,44,5,10,35,10,3,12,40,;		44,5,50,35,10,19,12,40,37,;		5,50,44,10,19,50,40,37,25,;		50,44,14,19,50,47,37,25,42,;		44,14,11,50,47,26,25,42,2,;		14,11,10,47,26,42,42,2,6,;		11,10,30,26,42,47,2,6,14,;		10,30,13,42,47,22,6,14,33,;		
11,39,15,9,21,24,5,25,45,;		39,15,43,21,24,49,25,45,12,;		15,43,24,24,49,50,45,12,39,;		43,24,49,49,50,2,12,39,38,;		24,49,20,50,2,38,39,38,21,;		49,20,30,2,38,16,38,21,18,;		20,30,2,38,16,15,21,18,48,;		30,2,34,16,15,33,18,48,19,;		2,34,15,15,33,13,48,19,4,;		34,15,8,33,13,32,19,4,45,;		15,8,35,13,32,34,4,45,32,;		8,35,27,32,34,46,45,32,14,;		35,27,20,34,46,2,32,14,20,;		27,20,10,46,2,3,14,20,44,;		20,10,35,2,3,12,20,44,32,;		10,35,10,3,12,40,44,32,1,;		35,10,19,12,40,37,32,1,6,;		10,19,50,40,37,25,1,6,1,;		19,50,47,37,25,42,6,1,7,;		50,47,26,25,42,2,1,7,43,;		47,26,42,42,2,6,7,43,49,;		26,42,47,2,6,14,43,49,10,;		42,47,22,6,14,33,49,10,47,;		
9,21,24,5,25,45,41,16,43,;		21,24,49,25,45,12,16,43,22,;		24,49,50,45,12,39,43,22,11,;		49,50,2,12,39,38,22,11,43,;		50,2,38,39,38,21,11,43,8,;		2,38,16,38,21,18,43,8,3,;		38,16,15,21,18,48,8,3,21,;		16,15,33,18,48,19,3,21,43,;		15,33,13,48,19,4,21,43,1,;		33,13,32,19,4,45,43,1,9,;		13,32,34,4,45,32,1,9,2,;		32,34,46,45,32,14,9,2,29,;		34,46,2,32,14,20,2,29,22,;		46,2,3,14,20,44,29,22,31,;		2,3,12,20,44,32,22,31,32,;		3,12,40,44,32,1,31,32,9,;		12,40,37,32,1,6,32,9,49,;		40,37,25,1,6,1,9,49,17,;		37,25,42,6,1,7,49,17,34,;		25,42,2,1,7,43,17,34,23,;		42,2,6,7,43,49,34,23,35,;		2,6,14,43,49,10,23,35,48,;		6,14,33,49,10,47,35,48,2,;		
5,25,45,41,16,43,27,36,20,;		25,45,12,16,43,22,36,20,18,;		45,12,39,43,22,11,20,18,22,;		12,39,38,22,11,43,18,22,31,;		39,38,21,11,43,8,22,31,40,;		38,21,18,43,8,3,31,40,17,;		21,18,48,8,3,21,40,17,22,;		18,48,19,3,21,43,17,22,24,;		48,19,4,21,43,1,22,24,19,;		19,4,45,43,1,9,24,19,47,;		4,45,32,1,9,2,19,47,3,;		45,32,14,9,2,29,47,3,6,;		32,14,20,2,29,22,3,6,43,;		14,20,44,29,22,31,6,43,34,;		20,44,32,22,31,32,43,34,48,;		44,32,1,31,32,9,34,48,17,;		32,1,6,32,9,49,48,17,33,;		1,6,1,9,49,17,17,33,18,;		6,1,7,49,17,34,33,18,43,;		1,7,43,17,34,23,18,43,36,;		7,43,49,34,23,35,43,36,6,;		43,49,10,23,35,48,36,6,32,;		49,10,47,35,48,2,6,32,28,;		


