    2    25    13    13    17    16    18    13    21     7    16    11    16    25    22    14     4     4    17    11 
   18    21    14    15     5     1    25    12     4     5     7    10    11    22    19    18    21    16    24     7 
   14    19    10    24     7     4    24    16    21     6    20     9     8     5     5    12    11    12    20    25 
   25     8     2    24     6    18    15    22    20     8     3     8    14     7    15     4    11    25    21    12 
   22     2    10    16     5     7     3    10    18     1    12     4     5     1    10     1    11    12    17     8 
   17    16     7    11    14     1    22     9     5    21     4    24     5    18    13    18     7    14    16     2 
    2    10    24    22     7     8    17    21    21     3    13    24    18    23    21    25     3    22    12    12 
   21    17     5    21    18    21     9     9    21    13    17    18    23    20     1    14     2     2    17     6 
   11    22     1     6    22    21    25     5    13     2    25    24    25     2     1     8    17    16    23     4 
    1    10     9    12    11    14     3    17     7     3     1     7    18    18     9     6     4    19     7    25 
   16    14    17    19     1    25     4     5     6    14    21     2     4    12    25    22    17    21    13     7 
   20    11    12    14    20    23    18     6     1    10    14     3    22    14    19    16    24    14    20    21 
    6    25    25    14     4    15     3     7    25    14    10    23     7     7     7    17     1     9    11    14 
   22     9     5    13    12    25    25    21    17     2    11    12    18    18    15    20     6    15    18     8 
   23    15    19    23    21    18    25     6     6     2     8    24     1    18     4    15    13     1     1    13 
    2    17    23    25     8    23     4    22     8    24     6     5     9     9     5    19     7     3    16     8 
   19    17     7    23    24    13    17     9    18    24     8     3    24    22    14     4    10    25    22    10 
   23     3    16    20     3     8    25     6    24     4     3    21     5    17    22    18     8    10    25     3 
   24    11    10    19    12    15     4    20    15    17     1     4    16    22    23    14     8     6    13     4 
   22     7     3    11    25    15     8    14    11     8    17     1     5    19    10    11     9     8    23    25 


   23     7     1    25    18    21     8    13     3    25     1     4    16    15     1     4     7     4    24     1 
   21     2     4    11    11     8     3    10    22    21    20     5    19    13    11    14    11    19     1    14 
   13    15     6     2    12    12     7     3     8     8    19    22    20    14     2    20    24     9    16     8 
    9     9    24     6    15    19     7    12    13    23     4    15    17    18    25    21    11    16    17    21 
    5     1    17     5    15    15     5     9     8     4    22    18    22    25    12    21    20     4    21    11 
   14    12    19     1     4     6    23    11    14    24     5    10    12     7    20    10    16    23     7     1 
   16     3    17     3    13     9    20     6     2     9    25    14    18    15     8    14     6    18    23    15 
   20     2    10    13    14    25    10    13     2     5     5     1     6    11    13     7    10     3    15    22 
   16    13     3    10     6    22     3     4    13    16     2    14    17    11    20    22     4     4     5     2 
   15    20    13    21    21    19     7    16     5    21    14    15    19    12    14     9    10     1    14     7 
   16    18     6    23     4    18     3     9     8     4    12    21     3    25    20    17    13    12    22    13 
   16    19    24    13    19    17     4    17     4    17    17     9    20    12    14    24    14    10    19    15 
    6    25     6    13     1     6    24    23     6     2    21    13    19    17     9    11     2     1     4    20 
    1     5    14    11     1    21    17    21     8     5    12    25     3     9    23     7     7     4    14    16 
   15    11    23    20    22    18    17    21    19    15     9    21    22     7    25    25    24    14     8     9 
    9    15    21    22    14    22    19     5     3    10    20     8     2    17     6    16    15    15    14     9 
    1     8     5     9    12    20     1    20    14     6    19     7    24     5    12     6    24    10    23    13 
   15    16     6    22    20    21    20    22     6    21    11    16    20     7    24    25     4    12    15    12 
   10    18     6    20     4    14    20    24     9    22    12    15    15     9    18     5    18     6    12     2 
    2    21     8    21    20    10     3     5     8    18     4    20     6     2    22     4    24    22    13     9 


   13    10    18    25     2    24    16    25    23    19     8    22    16    17    25     5     7     5    13    23 
    9    20    13    10    13     8    15    22     9    24    20    11     5     7    19    24     6    17     6    10 
   20    16    25    12     2    18    25    18    14     9     2     7     7    24    23     2    23    20    13     2 
   19    14    13    14     3    14    22    23     8     9     2    16     4     4    13     7    10     2     6    18 
   20    22    13    22     8     8    18     9    25    21    23    14     6     1    25    10    17    22     1    20 
   23    24     5    10     8     7    21    18    25     9    11    18    18     4     4    19     8    18     1    25 
   21     6    19    14     9    20     8    16    21    22     7     3     6    22    10    16    17    23    14     7 
    2    16    10    18    24    22    10     9    10    19    11     2    17    14    19     6    24    22    15    10 
   23    23    20     8    22    10     1    16    20     8    22    20    16    10    23    18     5    18    16    22 
   18     6    10    11     1     5     4    25    23    14    23    20    22    14     5    21    13     5     5     3 
   13     4    10     3    25    25     3    11     2     5    21    25    19    15    12    23     3    21    16    15 
   20     6    25    19    24    23     2    23    16    22    24    12    14    16    12    19     2    22    12     8 
   24    12    17    16    14    24    13    16    21     1     8    23     2     4    20     2    17    15    17    20 
   22    24     7    20    23    22     2    25    17    16    12     6    16     7    12    15     9    19    11     2 
   21    14     8     4    17     1    17     1     7    12    19     8    24    20    19     1     3    13     8     6 
   22    25    22    14    24     5     4    14    24    21    19     7    20     3     1     6     6    20     2    22 
   12     7     6    18    12    24    11     4     4     4    20     8    15    19    15    20    19    23     3     5 
   18     6     3    22    23    12    20    19    20     2     6     8    17    17    17     2    15     6    17     3 
   15    21    13     4    22    14     2    11     4    23    18     4    19    21    20     5    14    21    22     7 
   23    14     7    15     8    10    13    25     1    13     2    17     9     5    23    14     3    18    12    17 


    6    15    10     9    21     8    22    24     2    13     8     7     2    14    19    10    10    14     8    13 
   20    17     9    14    17    25    14     9     4     8    21     4    25     9    24     6    12     5    12    11 
   12    12    24    15    24    17    19    10    22    10    10     6    16    11    12    17    20    10    25    25 
    6     2    11    13    10    21     4    14    13    16     2     9    22    12    12     3     2    19     3    11 
    6    24    15    15    22    13    11     1     5     9    13     8    17    20    11     4    13     5    19     3 
   14     2     5     5    12    22     5     5     5    19     1    18    12    18    10    10     3    17    10    20 
   15    22    19     4    20    11    17     3    17     4    23    18    14     3    25    11    22    18    18     4 
   19     8     6    22     6    12     6    17     6     8    14    22     3    23    25    18    14     4    19    16 
   16     1    12    19    25    25     2    20     2     5     5     5     8    19    19     7     4    25     1    11 
    7     7    15    10    20    17     9    25     5    13    15    18    12    13    20    16     6    20    17    17 
   11    20     4     7     7    18    13    13     2    16    16     4    25    20    13     5     9     6     4    24 
   12    10    21    22     8    14    15    23    17    10    22    12    18    12    24     7    15    25     1    10 
    7    11     7    12    10     1    16     6     9    25    14    18    21     1     2     5     6    16    15     6 
   23    11    11    24    11    21    10    11    13     2     3    11    19     4     2    15     3    14    20     7 
   14    25     7     6    18     8     4     6    11    15     1     7     6     3    10    14     9    24     8    23 
   24     2    11     4     3    23     4    10    10    20    25    22     6    17    23    14     1    18     7     7 
   12    22    19    23     7     8    22    14    18     8    22    14     3    25    14    13    11     1    14    12 
    2    18     3     8    23    23    18     7    14    18     8    13    19    14     9     2    22     7    20     7 
   10    14    21    16    22     2     3     2    19    20     5    21    14     8    10     9    18    17    18    25 
   20    14     5    17    17     3     5    10    19    10     9     7     2     6    23    17    16    19    14     4 


   16    17     7    22     4    21     7    24     3    10     2    10     9    22    24    23    15    23    16    12 
    3    17    18    15    13    25    12     1    14    22    10    16    13     8    19    18    15    22     6    22 
   12    20     1    13    24     1    23     8     4    10    16    21     4    18    19    21    14     5     8    23 
   22    18     6    24    20    19     8    18    19     6     8    22    14    18    18    21    11     9     3    17 
   24    21    19     3     4    23     2    22    21     4    18    21    19     7     6     1    12    21    19    11 
   11     5    13    18    22    11    22    19     2     5     5    21    23     6    20     1     9    15    16    13 
   21    18    24    21    10    23    17     9    14    22    25     7     7    21    10    17    22    14    22    13 
    8    14    23     8     5     8    11    10    20    17    22    16    22    22    14    17    23    18     1    23 
   24    15    23    17    12     6    11    21     1     1    11     4    18    13     7    10     2    19    23    25 
    6    21     2    15    19    21    22     9     5    20    17     6    22    10    17    16     7     8    13     7 
    3    25    12    25    23    17     8    16     6     7    23     5    17    25    13    20    21     7     9     5 
    9    21    17    19     3    25     8    19    19    17    19     6    17    23    16     5    16    13    11    21 
   23     3    12    17    22    25    22     9    11    20    18    11     2     2     3    20    14    17    21     7 
   10    24    24     4    21     4    20    24    14    12    17     4    19    13    20     3    22    20    24     8 
   12     8    25    10    16     8    20    10    23    14    19    24    24     8    22     5     6     5    10    15 
   22     1     4    25     2    25    14     1    18    11    10    15    16     6    14    24    20    24     6     4 
   13    10    20    25     4     9    25    15    19    13    16     9    12    10    21     5    17    23    23    10 
   18    13    22     8    23    25    18     6    13    21    10    21    10    13    23    17     1     6    13     1 
    2     8    21     9     3     3    12     3    25     8    20     2     7    21    20    14     5     9    11    16 
   11    18    19     1     9    22    21    20    22    17     3     1    11    16    24    22    17     9    11     7 


   17    24    16    16     5    25     9     4     4     8     5     1    21    11     6    12    16    17     1     4 
   21    17    19    22    25    13    14     8    14    24    20    24     2    22    20     4     4    15    22    13 
   13     9    11    18     5     6    11    17     3    12     4    10    24    22     2     1    22    23    16    20 
   12    14    12    13    23    15     1     2    11    24    22     6     4     7    22     1    14    17    11    19 
    6    23     4     4    19    11    24    15     7     4    14    19     1    19    24    23     1    10     2    22 
   25     6     1     3    12    12    20    22    24    22    23     9    18    10    14     6    25     1     5    17 
    3    13    15    18     9    12    10    21    22    21     4    20    23    10    14    23    15     9    14     5 
   20    10    22    11    18     4    20    22    20    21    15     5    20    13    13     4    22     1     2    25 
   11    13    19    12    24    19     3    22    15    10    25    22    23    11    10     2    20    23    25    20 
   23    16    21    10     6    22    21    20    22     2    14     5     1     3    23     4    13    15    15    24 
   16    16    19     3    19    10    10    13    22    16     7    20    16    12     2    10    23    11     6     2 
   11    12    21    22    24    17     7    13     4    22     5    15     9     3    13    21     9    12     8     4 
    6    21    24    14    10    10    11     2    18    19     3    14    16    19    14    20    13    18    12     2 
    4     8    25     9    18     9    11    24    21     8     3     8    15    19    19    21     7    17     5     8 
    3     7     7    13    15    18     6    23    25    10     5     1    17     6     5    14     9    20    21    20 
    5    10    23    13    13    17    17     7    23    22     7    25    24    23    20     5    10     9    21    21 
   23    10    13    12    10    25     9    21    18    16    16     8    13     7     4    18    24    14    19    15 
   22     2     3    21    18    15    22    23    24     6    24    24     3     5     2    20    16    22    11     4 
   15     7    19    20     8     4     7    19    21    25    18    17    15     3    15    19    15    21     3     5 
    7    15    21    20     2     7    15    15     8    16    13    14    24     5    16    11     7     4    10    11 


   20     2    20     4    11    20    15    21     2    17     3    24    11    19     7     6     7     6     8    15 
   11    19     3    24    15     6    20     1    24    15    18    19     8     9     3    16     2     5     2    25 
   14    25    20     7    10     8     7     2    18    14     6    16     7    16     2    19    24    21    22    15 
    4     2     4     6     1     6     6     3    17    12    14    18     7    16    11     3     3    11    22    22 
   10    23    21     9    25    16     7     8     6     6    22     8     9    14    10     5     1    23     6    16 
   10    11     5    21    18    10     2    23    13    21     9     7    19     9     1     7    16     7     3    14 
   24    20     3    14     8    25    15    24    14    25     4    14     9     8    10    14    15    14     5     4 
   11    12     2    14    25    24    11    20    16    25    10     7     9    13    13    18    21    24     6    21 
    6     6    16    17    15    17     2     7     3    24    10     3    20     9    24    21     7    21    24    25 
    1     3    17     7     2    12     9    22     6    16    23    15     1    23     6    20    16    14     4     8 
   11    16     4    25     9    25    14    22    10    19    23    21    18    17    20    22     4    18    14    14 
   23     6    22    10     4    22    20    12     7    20     3    12    24    23    22    16    18    19    19    19 
   19     2    23    23    15     3    15     9     1    12    11    18     5    25    20    22    19     6     4     4 
   16    21    21    10    14    11     1     7    17    15     4     9    11    16    10    19    17    15     3    22 
    2    24    11     5     9    12     8     8    11     5    10     5    13    17     7    11    21    20    16    17 
   18    18    10    13    16    19    11    20    18    15     4    16    12    15     6    25    18    23    24     5 
    3    10     6     6     8     9    22     4    15    12     6    22     1     5    20    17    16     2    12    22 
   12     2     4     8    24    19     8     3    10    23    18     5     4     7     8    11    14    11     6    19 
    4    14    23    25    17    25    14     4    14     8     2     2    20     2     7    10    13    12    11    14 
   25     5    11     7    22    18    23    13     1    11    10    12    12    24     4    21    10    13     7     4 


    3    17    14     1     4     3    25    16    10    10    21    19    22     4    21    19    22     8    14    13 
   20    19     8    14     2    22    22    18     3    23    23    24    13     5     8    11    12     9    21    11 
   17    14     1    25     1    19    25    10    12     4     6     1     9    24     1    12    18    18    11    24 
   15    22    16     8     6     1    12     6    22     6     6     6     3     1     5    23    18    11     1     3 
    5     2     4    13    18     1     7     9     5    13    12     3    25     1    15     7     6    19     3    20 
   20     4    12    14    12    19    12     1    12    12     2    11     6     5    22    23     8     8     1    17 
   11     7    14     5    17    18     7    24     3     2     4    17    12     2    19    14     2    20     9    11 
    5    24    11     8     8    20    19    11     1     3    12    17     3    16    19    19    23    22    20     9 
   11    10     4     8    21    10     6    13    12    19    15    23     5    21    23    18     6    22    24     4 
   17    10     8    16    15    22    11    15    21     1    11    19     6    24     3    14    14     9     3    10 
    7    13    10    19     5     5    13    10    10    12     8     7     2    17    16     4     1    13     9    15 
    4     9     6     1    19    10    12    18     2    23    16    15     3    16     1     7    17    16    17    23 
    1    14     4    11    14    20    19    19    14     4    19     5    16    11    14    17    17    22     1    17 
   12    11    22     1    13    22    25    10    18    25    10    25    12    22    14    20     3    17    23     6 
   21     1     4     4     4    25    10     5     7    20    21    22    10    22    20     1     7     6     9     7 
    5     4    20     9     5     7    10    19     9    22    19    11    16    15     2    13    14    23     8    11 
   14     4    13    19     6     7     8     4    10     8     3    22    17     9     4     5    23     5    16     9 
   16    25     3    14    23    19    21    22     6    12     8    24     3     2    19    14    12    13    20    18 
   10    13     3     6    19    15    25    14    18     4     9    13     2     9    25     7    20    15    23    10 
    5     9     3     3     9    10     6    17    25     6    21     7    10     4    10     7    12    20     4    22 


