    0     0     0     0     0     0     0     0     0     0     0     0     0     0     0     0     0     0     0     0     0     0 
    0    14    24    18    12     4     9    10     0    25     8     0     9    18    16     6    18    14     3     7    18     0 
    0     0     8    20    14    24     3    18     6    15    15    15    19    20    17     9    18     5    17    14     5     0 
    0    16     2     4    23    25     8    14     6     7     9    18     9     4     7    12    13     2     7    20    16     0 
    0    11    25     2    16     5     6    15     6     8     2    20     8    24    25    14    22    10     9     7     9     0 
    0    20    11     2    13    14    24    10    15     7    15     3    20    22    19    23    25     7     0    23    22     0 
    0    12     2     2    19    10     4    20     0    24    10    16    23     6     3     4    14    12    25    19    13     0 
    0    12     0    13     6    18    14    13    13    21    17    12     7    23    25    20     6    20    25    12     6     0 
    0    23    16     7     6    18    25     9     5    11    12    25     4     2     2     2    24    20     0    10    23     0 
    0    15     0    17    21    21    21    23     0    24     4    22    14    12     6     1    16    24     7    19    12     0 
    0    13    12    17     8    17    11    17    22     8     8     4    25     6    13    21     5    17     7     8    10     0 
    0     3     8    18    23     9     5     2    15     1    16     1    19     9     7    21    20     1    20     8     5     0 
    0    16    23    16    24     9     3     7    19    12     4    23    23    16    10    14    25    20    24    13     0     0 
    0    15     4     6     5    25     5    12    10    13    13    25    25     0    21     3    19    12    18     1    12     0 
    0     5     7     7    21     0    22     4    14    10    10    20     1     5    15    19    24    20     6    16     3     0 
    0     0    14     3    11    17     3    17     3     8     9     9     1    11    14     8    23    23    12    18    11     0 
    0     9    21     0     3     5    11    17    17    20     5    13    12    20    24    20    12    22    15     6    25     0 
    0    14    11    21     6     0    10     0    17    10     7    11     1     5    11     4    24    14    20    22     5     0 
    0    20    25     6    10    14    20    13     0    24    24    10     0    23    15    25    17    25    22    17     4     0 
    0     1    11     4    14     6    10    24    11    20     0     5    13     9     7     5     1    25    24    12    24     0 
    0    14    24    11    19     5     9    10     0     9     8    24    13     3    11    24    11     7    17    24     3     0 
    0     0     0     0     0     0     0     0     0     0     0     0     0     0     0     0     0     0     0     0     0     0 


    0     0     0     0     0     0     0     0     0     0     0     0     0     0     0     0     0     0     0     0     0     0 
    0     8    20     4     8     3     9     2     6    15     1    10    22    13    21    18     1    10    13    17    16     0 
    0     9     9    10     4     9     1     4     6     8     6    25    19     0    23     8    12    22    20    12    18     0 
    0    24    17     6    14    10     1     5    19    17    16     1    24    11    20    22    19     1     8    19    24     0 
    0    15    15    14    19     8     2    22    16     5    15     4    12    14    14    17     1     2    10     8    14     0 
    0    23     7    13     9    11     1    15     4    10    19     4     4    20    11     1     7     9     1     2    22     0 
    0    23     0    23    24    25     9    22    18     6    22     7     1    19     7    21     5     4    23    10    23     0 
    0    19    10     1    13     8    23     1     3     5     4    22    18    19     1    15     3    24     2    23     9     0 
    0    11    14    16    20    14    24     3     6     2    19    15     0    19     4     3     8    10    21     6    25     0 
    0    22    11     3     4     0    17    20    11    11    12    22     9     0    14     4    13     8     0     9    23     0 
    0     2     4    20    22    19    15    17    11     6    15    10    22     3    22    13     1     1    19     1    22     0 
    0     8     1    25     7     3    13    20    19     0    20    13    13    14    11     4    16     6    11     1    17     0 
    0    15    20    10    25    25    11     9     4     2    16    25    13    24    11    23     9    11    14     6    18     0 
    0     5     2    19    25    22     1    17    20    10    22     0    17    23    17    22    15    23     5     8     8     0 
    0     9    24     6    12    23     4    14    11    10     5     4     3    17     0     0     3     0    10     0    16     0 
    0     2    18     5     7    10    22     6    21    25    12    10    18    24    24    10    23    18     0    13     4     0 
    0     0    17    23     9    24     7    22    12     7    25    18    17    20     6    13    22    17     3    10    19     0 
    0     0    22    25    12    24    13     2     4     5     4    17    16     3     6     4     7     8    13    13    10     0 
    0    15    18    15    14     1    19    14     5     2     8    22    11    22    17    16     5     9    22    14     2     0 
    0     2    18     5     2    18    16    20     5     8     9     4     4     5     9    19     4     9    21    25    22     0 
    0    20     1    14     7    17    10    14    11    15     5    24     9    15    16    11     0    23    25     8    20     0 
    0     0     0     0     0     0     0     0     0     0     0     0     0     0     0     0     0     0     0     0     0     0 


    0     0     0     0     0     0     0     0     0     0     0     0     0     0     0     0     0     0     0     0     0     0 
    0    23    14     6    22     7     7    25     0    17     6     5    14    17     0    19    11     8    13    14    10     0 
    0    25     9    23     0     8    19    25    11    11     4    10     9     2    12     7    12    18     0     8    16     0 
    0    14     6    18     5     3    22    22     7     7    11    25    13     9    20    21    10     7    11     3    17     0 
    0    11    14    12     3    17    12     5     1    19    19    18    21     2     0     2     9     1     1    21     8     0 
    0     0     8     2    17    23     7    19    14    14     1    12    13     2    13    10    11    15    13    25    19     0 
    0    24    23    20     6     9     5    24    20    22     6     4    18    19     1    10    14    13     5    18    22     0 
    0    15    13    24    18    24     9    18     1    16    19     0    11    10    17    17    25    12    18    10     1     0 
    0     9     6    23     5    10    23    16     5    17    20    17    22    10    19    20     6     5    21    23    18     0 
    0    25     5     7    15     3    20     9    21    11    17     9    13     1    22    22     2    23    18     3    19     0 
    0     8     4     8    15    20     2     1    11     1     7    24     5    23     8     3     5    13    22    18    23     0 
    0    20    13     8    22    13     6    21     5     2     5    11    15    18     3    11    19    25     3    12    17     0 
    0    23    21    12    10    23    10     8    21    13    15    10    17     6     9    11     0    15     8     8    25     0 
    0     7    23    20    15    12    22    15     4    18    17    25    10     7     8    24     1     1    17     9    13     0 
    0    13    18    10     9    25     8     7    24     9    23     4     7     0    23    12    23     8    20     0     7     0 
    0    11    11    24    16    17    12     6    16    16    21    10     8    10    19    21    10     8    18    20    23     0 
    0    23    17    11     0    19     4     5    19     6    12     8    20     9     2    13    17    14    10     8     0     0 
    0    22     0    25     4     3     4    18     0    24     0     5    18    21     2    15    20     5     6    10    12     0 
    0    13    14    16    25     8    15     9     8    24    23     1    11    11    19     3    20    16     3    24     1     0 
    0    15    22    13     1     4    23    14    12    12     0    18     0    14    11     6    25     8    17     5     7     0 
    0     3     7    21    13    22    19    14    22    18    21    14    19    22     2     4     1     0     9    25     9     0 
    0     0     0     0     0     0     0     0     0     0     0     0     0     0     0     0     0     0     0     0     0     0 


    0     0     0     0     0     0     0     0     0     0     0     0     0     0     0     0     0     0     0     0     0     0 
    0     9     1     3     1    19     2     4     2    15    21     3    10     9     1     7    19     1     9    17     1     0 
    0    16     4    21    12     2    15    10    19    22    17     4    25    10    24     7    12     4     3    19    14     0 
    0    18     6     9    20    19    10     5    11    25    13     4     8     0    13    11    22     4    18     1    24     0 
    0     4     4    14    23     4    13    12    22     2    18     1     9    16    25    11     8     7     5     2     2     0 
    0    16     1    16    24    23    10    19    11     0    23    14    22    14    15     1    19     2    19    11    14     0 
    0    13     4     1     9    12     1    19    25    18     7    22     7     8     2    21    22    18    14    25    10     0 
    0    13    12    19    12     2    18    21    18    21    19    22    23    12    17    15    18     5     2    14     9     0 
    0    17    21    22    25     5     5     4     5    16     9    23     6    18    15     4    11    13    13     2    14     0 
    0     5    10    11    18    12    10     4     9     1    22     9    25    24     3     0    16    19     2    17    22     0 
    0    14    23     3     7    12    24    18    22     5     9    20    13    18     0    12    24    14     9    21    17     0 
    0     2     2    22    10     2    14     7    19    13    21     1    16    23    22    20    14    25    12     1    15     0 
    0    14    17    10    16    24    13     5     8    15    14    12     3    22    22    18     8     6    21    19    20     0 
    0     9    23    16    21    22     0    22     1     2     5     2    22    11    23    23    21    21    14    13    11     0 
    0    20     6     2     3     6     6    11     9    17    25    10     4    22     0     4    15    11    11    10    11     0 
    0    11    18     7     1    17     8     8     7    24    16    10    23     4     8    22    13    11    10     8    22     0 
    0    20    10    21    20    15    21    19    22    12     1    14    17    22    22    20    19    18     0    19    18     0 
    0    11    14    12    12    25     6     0     7    10    19    17    20    23     1     5     0     7     1     5     4     0 
    0    22     0    14    21    20    23    20    25    20     5    22    16     6    20    17    21     6     1     3    14     0 
    0    23    14     7    18    18     8     3     7    11    23     2    13    10     7     0    20    22     0    11     4     0 
    0    25     7    24    15     4     6    20    23    22    24    18     4     1     7    12     8     3    23    21    18     0 
    0     0     0     0     0     0     0     0     0     0     0     0     0     0     0     0     0     0     0     0     0     0 


    0     0     0     0     0     0     0     0     0     0     0     0     0     0     0     0     0     0     0     0     0     0 
    0     2    15    22     8    15    19    22    23     7     4    23     8     1     2    13     0    15    15    10    12     0 
    0     8     2     9     6    21    19     4     5    11     2    10    24     2     1     7     4    10    20    24    21     0 
    0    25     9     6     0    15    22     4     2    19     8     5    10    12     7     5     5     5     5    23     2     0 
    0    11     1    25    10    24     2    19    23    25    17     7     9    20     4    25    16    22     3    12    21     0 
    0     4    24     1    22    22    19    18    11     1    21     1    23    22     1    16     0     6    22    19     5     0 
    0    22    13    14     5     0    11     2    16     3     0    11    20    11    11    20    17     0     6    12    25     0 
    0     3    23    14    24     5    21    14    23    25    14     2     7     6     8    17     8    19    16    12     1     0 
    0    14    17    17     0     3    24     5     3     5    21     7    10     4     1     5    15    25     0    13    25     0 
    0     7     2    17    15     2    24     2    22     9    24     1    17    21     7     8     8    19    16    19    10     0 
    0    10    10     3     3     3     2     2    19     8    12     1    20     0    25    22     9     8     3     9    20     0 
    0    25     0    16    19     9    19     4     6     1     0     3    17     9    24    17    21    20    25    22    11     0 
    0    16    18    15    17     0    10     6    18     7    16    24     5    16     1    14    10    15    13    14    23     0 
    0    17     8     2    12     3     3     1    14     3    12     9    13    18     6    13    20     1     4     2    24     0 
    0    17    24    24    19     4     9    25    11     8    24     9     5     6    16    25    14    23    25    24    21     0 
    0     1     0     0    13     1     3     6    21    16    15    22    23    13    12    11    24    14     0     4    21     0 
    0    13     9     5     0     6    18     3    14     2    24     7     9    23    23    25     4    21     2    23     1     0 
    0     6    15    13     3     4     8    20     1    14     9    16     7    13    24    17    19    14     2     6     1     0 
    0    19    24     8    16    16     0     7     4     8    17    20    23     5     5     9    25    25    25    16     6     0 
    0    21     9     9    24     0    13    20    15     5    19    10    20    15    24     5     2     5    14     7    21     0 
    0     6    11    12    15     9    18    14    20     2    17    16     7     2     2    14    20     6    23     9    16     0 
    0     0     0     0     0     0     0     0     0     0     0     0     0     0     0     0     0     0     0     0     0     0 


    0     0     0     0     0     0     0     0     0     0     0     0     0     0     0     0     0     0     0     0     0     0 
    0    23     4     6     3    11    22     0    19    14    24     2     8     8    20    17    24    14    23    23    23     0 
    0    19    16    10     9     5     4     5     9    21    16    19     6     5    13    17    11     6    10    11     2     0 
    0    16    16    16    23     3    25    23     0    10     0     1    25    16     9     4    20    10    23     0    23     0 
    0     9     0     0    16    17    11    17    11    25     3    23     2    12    25     9     7    12    10    19     1     0 
    0     1     1    14     3    20    21    17    14    16    14     0     5    19     1    18     6    15     0    24    12     0 
    0    14     4     6    13    25    12    24    17     7    22    23    19    17    11    14     3    16     5     2    11     0 
    0     2     9    17    25     8     4     0    22     2    17    20     0     3    24     3    22     6     1    13     9     0 
    0    18     9     0    25     5     1    18    18    10     0    13    19    22    23     8     2     4     7     7    14     0 
    0     2     9     6     0     2    10    12    12     6    14    12    24     9    12    12    23     4    17    23    18     0 
    0    20    18     7    20    16    15    20    22    23     4    20    18    13    22     7    18     0    14     9     7     0 
    0     7     0     2     5    11     3    10     1    15     7    21    10     2    18    13     1     9    12     5     0     0 
    0     6     1     3     8    19     4     3     1     4    14    22    21    11     5     2    13    12    14     4     9     0 
    0    15    15    10    14    23    17     0    23     9     4     6    20     9     8    15    24    17    25     9     1     0 
    0    25    19     8    10     3     9    23    25     6    24     2    17    17    21     8    11    14    23    23    22     0 
    0    22    17     6     7    15    18    13     6    23    13    24    16    21     1    20     1    19     6    17     9     0 
    0    17    15     1    11    15    20    15     8     8    12     1     2    18    25    22    24    21     3     1    11     0 
    0     2    16    11     4    15     7     4    15     5     4     2    17     8    25    13    11     1    22     4    16     0 
    0     3    18     8     9    22     8    14    16    21    24     7    16    18    19    11     4    12     1    23    20     0 
    0    15    10    20    19    21    12    24    25     1     7     9     6    18    22    12     8    23    15    18     6     0 
    0    11     4    10    10     1    14    13    20    10    21     2    12     2     3     4    12     2    10     7     1     0 
    0     0     0     0     0     0     0     0     0     0     0     0     0     0     0     0     0     0     0     0     0     0 


    0     0     0     0     0     0     0     0     0     0     0     0     0     0     0     0     0     0     0     0     0     0 
    0    14     9     5    11    25     8    25    10    19    25    18    24    24     8    24    12    25    18     7    10     0 
    0    12    16     1    17    18    17     4     7     2     2    12    11    18     6     0    12     0     4    15     4     0 
    0     8    12    23     6    19    24    12     8     3     6     3    24    19     5    16    10    14     6     4    19     0 
    0    21    20    16     7    20    13     6     1    25     8    25    24     6     4     6    16    25    20    23    17     0 
    0     7     5     2    19     1    15    25    14    13     9     2    13     9    11     9     9    16    14    20    21     0 
    0    24     0    22     7    15    13     9    21    20     7    13    25    12     6     5    21    11    18     3     8     0 
    0    16    20     2     7     8    12     8     4    22    19    19    12     5    22     9     5    25     4    12    24     0 
    0     1     9    22    25    10    14    19     1    17     1    13    19    19     4    16    24    14    11    20    22     0 
    0    20     3    17    22    18     7     4     5    14    16     1    17     7    12    23    21     1     5     2     0     0 
    0    15    11     2    10     3    24    23    20     1    22    15    25     3     2    20    23     6     1     6    20     0 
    0     0     5    19    11    22     7    10    10     5     2    21    21    15     2     1    21    18    16    20     3     0 
    0    11     8     8    19     1    21    18     4    23    14    25    22    10     1     8     6    20     7    11    23     0 
    0    14     0     4    11    16    18    24     7     5    16    10    19    10    25    18     0    20    16    24    12     0 
    0     0    14    19    14    16    11     6     5     2    14     3    16    25    17    24    14     2    25    14     1     0 
    0    17    23     1     5     8     0     0     1    17    24     2     2    15    25    21     7    10     4     4    24     0 
    0    10    16     1     7    10     0     1    23    15    22    23    14     7    10    20     1    17     9    11     9     0 
    0    12    23     9     4    12    14     3     4    23    23     4     9    13     6    24    15    25     3     0    23     0 
    0    16    15    16    17    14    25     5    20     1    18     7    20     9    13    21     0    18    12     2     3     0 
    0    11    21    14    10    22     8    14    18     4     3     7    12    21    23    12     0     0     8    13    25     0 
    0    19    15     9    18    15    20    13    25    20    19     8    16     2     5    13    20     0     0    12     7     0 
    0     0     0     0     0     0     0     0     0     0     0     0     0     0     0     0     0     0     0     0     0     0 


    0     0     0     0     0     0     0     0     0     0     0     0     0     0     0     0     0     0     0     0     0     0 
    0    23    21    10     4    18     1    12    20    20     9    24     1    15     0    13     0     5    25     0     8     0 
    0     5    18    11    18    24    14    19    17    17     4    14    18     5     3    22     2     2    19     5    18     0 
    0    23     7    12     4    19    20    25    23    25    24    25     2    22    23    11    13    13    15     2    23     0 
    0     4     6     3     0    22    14    18    17    17    14     4    23    16     5    17     4    23    10    21     1     0 
    0     1    22    22    23    20    21    15    17     6    24     1     9    23     3    21    22     2    20    20    22     0 
    0    19    14    16    21    24    20    16    16     0    11    21     8    17    12     8     5    14     9    24     3     0 
    0    13     4    15    25    11    13     3     5    18     6    14    15     1    25    24    25    13    18     6    13     0 
    0    14    14    16    16    10    25    23    21    15    15    10    20    13     9    11    19     5    16     0    22     0 
    0     2    22     0     1    20     4    17     4     5     4     8    22     3    25     1    12    11    11     5     5     0 
    0     7    12    18    18     6    15     8     5     7    17    14    13     1    20     7     5    21    10     0    17     0 
    0    20     6     3     5     7    21    19    11    16    12    21    10    25    18     4    14    21    13    19     3     0 
    0     4    11     2     8     0    10    24     7    19     5    16    16    15    14    16    23     0    21    13    10     0 
    0    17    16    12    17    19    22    23     0    20    25    16    15    24     4     8     5    13     5     3     7     0 
    0    22     1     0    20     1    17    20    14    16    14     4     7    14    22    13     4     2    21    21     2     0 
    0    17    15     2     7    22    14    22     6     5     6     4    11    12     1     3     4    20     1     5     8     0 
    0    24    23     2    16     1     5     8    18    20    14     1     6     9    25     7    19    16    24    14    21     0 
    0    22    17    24     4    16     5    21    21    17    13    22    17     7     3    12    24    22    14    14    21     0 
    0     5     8    11    24    16     7    17    16     5     4     0    14     1    24     9    23     0     6     7    24     0 
    0     6     4     8    10    16    11     8    20    21     0    16    15    24     7    20     9    15    20    18    23     0 
    0     0     0    20     3     5    14    13     8     0    22    20    21    11     2     5    17    25    22    24    24     0 
    0     0     0     0     0     0     0     0     0     0     0     0     0     0     0     0     0     0     0     0     0     0 


