    6    10     9     8     4     7     4     3     8     7 
   10     6     2     8     8     5     9     1     6     6 
    9     6     4     6     2     9     9     5     2     7 
    8     3     2     4     6    10     7     5     6     2 
    3     7     2     9     9     6     4    10     5     4 
    6     6     2     7     7     3     3     1     3     3 
    7     9     5     7    10     9     5     5     7     3 
    9     1     6     2     1     1     6     6     2     6 
    6     6    10     5     2     9     7    10     4     2 
    9     4     6     7    10     3     8     7     5     7 


   10     7     4    10     4     8     3    10     1     7 
    5     6     2     8     3     8     8     4     6     6 
    5     5     9    10     2     8     8     6     3     2 
    1     8     7     3     1     2    10     4     4     3 
    2     2     3     6     6     1     8     9     3     4 
    9     7     2    10     1     2     7     9     8     2 
    2     5     6     3     7     1     3     8     4     7 
    3     9     2     5     9     1     6    10    10     8 
    7     7     1     7     4     9     4     1     9     3 
    8     4     6     7     2    10    10     8    10     3 


    4     4     2     4     5     3     3     8     3     3 
    8     7    10     6     7     5     7     7     9     7 
    5     9     7     3     3     1     3     3    10     7 
    7     5     5     4     7     1     6     7     2     2 
    1     4     2     8     6     3     9     3     6     6 
    7     5     4     4     9     2     9     4     7     7 
    1     6     3     9     5     5     8     3     5     9 
    2    10     3     9     7    10     7     4    10    10 
    9     5     9     8     6     1     9     1     6     1 
    3    10     4     3    10     9     8     3     9     9 


    4     2     1     9     1     9     2     7     5     9 
    8     6     2     7     8     1    10     9     3    10 
    8     8     7     6     9     1     2     5     2     3 
    9     4     3     4     4    10     7     7     4     3 
    7     1     2    10     2    10     7     3     2     6 
    3     7     7     2     6     9     4     2     2    10 
    8     5     3     3     9     5     3     5     5     3 
    4     3     4     5     2     4     5     8     4     7 
    5    10     5     2     8     4     9     8    10     1 
    5     3     2     9     9     8     8     8     3     1 


    9     7     6     1     2     7     9    10     5     7 
    3     5     9     4     4     5     7     3     5     4 
    1     6     3     6     5     6     5     8     1     9 
    7     6    10     5     7     3     9     1     8     6 
    9     1     9     9     3     9     9     7     7     4 
   10     8    10     9     3     6     3    10     7     7 
    3     5     8     9     7     3     8    10     5     4 
    3     5     1     1     6     7     5     9    10     1 
    5     2     4     5     9     6     5     5     8     5 
    9     1     8     1     3     4     6     6     6     8 


    3     2     7     2     4     1     5    10     9     5 
    9     1     5     9     1     6     5     4     9     9 
    3     2     9     4     8     1     6     4    10     7 
   10     8     3     2     8     7     5     1     9    10 
    2     3     8     5     2     4     8     9     3     5 
    8     1     3     3     4     3     1     3     2     3 
    9     8     3     5     7     5     6     2     7     5 
    1     9     6     5     1     3     4     7     4     1 
   10     2     8     3     7     5     8     3     3     9 
    9     7     1     4     5     1     1     4     6     1 


   10     9     5     6     3     3     4     3     7     3 
    5     5     4     2     9    10    10     8     3     7 
    3     9     5     8     7     5     5     2    10     9 
    1     3     7     7     9     6     1     9     9     2 
    2     3     7     1     9     4     3     7     7     2 
    3     3     3     8    10     1     5    10     7     1 
    5     4     6     7     9     5     3    10     2     3 
    9     6     3     1     6     4     4     3     6     9 
    9    10     2     9     7     6     5     1     4     8 
    4    10     1     1     3     8     2     8     4     1 


   10     5     3     7     3     9     9     9     6     3 
    2     6     4     9     1     7    10     3     3     3 
    9     4     9     9     1    10     3     7     7     7 
    9     5     4     8     9     5     5     2     2     3 
   10     4     4     5     7     3     6    10     5     2 
    4     1     9     1     7     9     3     8     5     8 
   10     8     5     4     9     6     7     7     1     8 
    9     1     1     4     3     8     7     8     4     6 
    7     5    10     5     7     8    10     6     6     8 
    8     4     2    10     8     4     8     1     7    10 


