     6     10      9      8      4      7      4      3      8      7 
    10      6      2      8      8      5      9      1      6      6 
     9      6      4      6      2      9      9      5      2      7 
     8      3      2      4      6     10      7      5      6      2 
     3      7      2      9      9      6      4     10      5      4 
     6      6      2      7      7      3      3      1      3      3 
     7      9      5      7     10      9      5      5      7      3 
     9      1      6      2      1      1      6      6      2      6 
     6      6     10      5      2      9      7     10      4      2 
     9      4      6      7     10      3      8      7      5      7 
